人	人入
口貝	員唄员呗
巳	己已巳
口力	另叻
日冖車	暈暉晕晖
木口	束杏
日亠口小	景晾
尹口羊	群羣
口巴	吧邑
口	口〇
木冂木冂	棘棗
口八	只叭
山手戈	峨峩
木日	東杳
士口䒑口	喜囍
丶艮阝	郎郞
女臣	姬姫
行	行彳
山夂丰	峰峯
九日	旭旮
之	之辶
亼口人刂	劍剣
日干	旱旰
阝爪彐心	隱隠
禾爪彐心	穩穏
艹千二火	薰薫
口口甲一	單嘽
行山王攵	徵徴
田匕匕	毗毘
金日勿	錫锡
山厂土土	崖崕
山鳥	嶋嶌
匚	巨匚匸
阝大人人	陝陜
习习立	翌翋
臣巳火	熙煕
日小兀	晃晄
日文	旻旼
王丶	玉玊
亻刀丶	仞仭
一中甘衤	囊嚢
土土土兀	堯墝
山刀又	岌岋
召儿丶	兔兎
艹召儿丶	菟莵
月厶八夂	脧朘
王王心丿	瑟璱
月屮凵	朏胐
手戈鳥	鵝鹅鵞
禾尤山	嵇嵆
木四	柬柶
口口口木	噪喿
亼口刀丶	劒剱劔
宀臣	宦宧
山𠂉匕	岝岞
山亼㇕	岑岒
金乂八夂	鍐鑁
革刀丶	靭靱
几木	朵凩
石水	泵砅
日勿	易昒
山𠂊厂卩	峗峞
土爪寸	埒埓
口耳	咡咠
長彡四日	鬙鬠
木工	杠杢
木人冂厶	檎麶
艹亠厶儿	茺萒
月勹口	朐胊
山亠丁口	嵜﨑
木且	柤査
山亼月刂	崳嵛
山亼月巛	崳嵛
口口口山	嵒喦
糸白水	線缐
彡頁女	嬃媭
竹亼口刂	箚劄
广匕頁	廎庼
士冖几殳	殼殻
木予丿木	楺楙
王見	現现
言八口儿	說説说
工頁	項项
長	長长
木示	标柰
木廿由八	橫横
龍	龍龙
頁	頁页
車	車车
車斤日	暫暂
車九	軌轨
車欠	軟软
齒	齒齿歯
口力刂	別别
口馬	嗎吗
貝攵	敗败
冂人	內内
貝𠂆又	販贩
見	見见
貝立口	賠赔
川頁	順顺
亻門	們们
亼龴頁	領领
金十目廾	鎮镇
彡頁	須须
金戈	銭钱
金卜口	鉆钻
金手丶	鉄铁
金夂口	鉻铬
月長	脹胀
月弋二貝	膩腻
魚	魚鱼
鳥	鳥鸟
言用口	調调
言斤丶	訴诉
言殳	設设
言亠丩人	該该
門耳	聞闻
門十丿	閉闭
門口	問问
門日	間间
門	門门
氵貝刂	測测
宀艹見	寛宽
冖車	軍军
馬	馬马
皮頁	頗颇
馬户冊	騙骗
弓長	張张
弓刂貝	費费
糸工	紅红
糸一屮	純纯
糸田	細细
糸且	組组
糸亠厶儿	統统
糸户冊	編编
干頁	頇顸
丁頁	頂顶
一弋止鳥	鵡鹉
一夕口貝	殞殒
士口頁	頡颉
走牛儿貝	趲趱
夫夫車	輦辇
夫見	規规
一兀頁	頑顽
大䒑頁	頬颊
王龍	瓏珑
王頁	頊顼
王之車	璉琏
王貝貝女	瓔璎
丰貝	責责
丰月見	靚靓
王馬	瑪玛
扌龍	攏拢
扌口貝	損损
扌牛儿貝	攢攒
扌門	捫扪
扌門夂口	擱搁
扌⺍冖見	撹搅
扌冖車	揮挥
艹長	萇苌
艹龍	蘢茏
十戈車	載载
艹之車	蓮莲
艹口隹頁	顴颧
艹日大馬	驀蓦
廿乚貝	貰贳
十目廾頁	顛颠
艹見	莧苋
艹鳥	蔦茑
艹言勹亡	藹蔼
艹門隹	藺蔺
艹冖車	葷荤
艹糸勹丶	葯药
西示風	飄飘
木長	棖枨
雨而頁	顬颥
木龍	櫳栊
木戈	栈桟𣏾
木之車	槤梿
西貝	賈贾
木見	梘枧
木風	楓枫
木魚日	櫓橹
木口𠂊貝	賴赖
木門口口	櫚榈
石頁	碩硕
石車	硨砗
厂貝刂	厠厕
石見	硯砚
龍土	壟垄
龍石	礱砻
龍言	讋詟
厂亻隹貝	贋赝
犬犬犬風	飆飙
龍衣	襲袭
石馬	碼码
車干	軒轩
車土口衤	轅辕
弋二貝	貳贰
車耳乚	輒辄
之車	連连
車乚	軋轧
車甫	輔辅
臣頁	頤颐
車至	輊轾
車口耳	輯辑
匚中一貝	匱匮
車口八	軹轵
車由	軸轴
車日匕匕	輥辊
車冂䒑亡	輞辋
車亼月刂	輸输
車人王	輇辁
車斤土	塹堑
車斤金	鏨錾
牙鳥	鴉鸦
車亠八乂	較较
車亠月攵	轍辙
車鹿	轆辘
車米夕㐄	轔辚
車宀丰口	轄辖
車尸廿衤	輾辗
車召	軺轺
車刀丶	軔轫
一屮頁	頓顿
車巛田	輜辎
齒止匕	齜龇
卜圍乂	鹵卤
止癶頁	頻频
卜貝	貞贞
虫見	蜆蚬
齒亼龴	齡龄齢
止匕貝	貲赀
齒尸至	齷龌
虫馬	螞蚂
中一貝	貴贵
口丰貝	嘖啧
足艹門隹	躪躏
口龍	嚨咙
口齒	嚙啮噛
口口丂頁	顎颚
圍口貝	圓圆
口貝阝	鄖郧
足牛儿貝	躦躜
口月鳥	鵑鹃
口魚日	嚕噜
口鳥	鳴鸣
口糸勹丶	喲哟
日一止頁	題题
田木頁	顆颗
日龍	曨昽
小兀冖車	輝辉
非車	輩辈
甲鳥	鴨鸭
日見	晛𬀪
日爪𠂇又	暖暧㬊
小冖口貝	賞赏
貝一弋止	賦赋
貝十⺍丶	賕赇
巾長	帳帐
貝長	賬账
巾丰貝	幘帻
貝十丿	財财
山十廾頁	巔巅
貝甫寸	賻赙
山而頁	顓颛
目龍	矓眬
貝𠂇月	賄贿
冂大鳥	鴦鸯
貝戈𠂇	賊贼
山車斤	嶄崭
貝卜口	貼贴
巾卜貝	幀帧
貝口儿	貺贶
貝日勿	賜赐
目見	睍𪾢
貝貝女	嬰婴
貝	貝贝
貝耂	賭赌
貝刂	則则
貝夂口	賂赂
四言刂	罰罚
貝广土	賍赃
貝八四日	贈赠
貝䒑刂八	賺赚
山巳	岂屺
竹龍	籠笼
牛口鳥	鵠鹄
竹見	筧笕
禾几頁	頽颓
牛儿儿貝	贊赞
竹門日	簡简
竹馬	篤笃
亻長	倀伥
亻丰貝	債债
亻十艹貝	僨偾
亻木鳥	鵂鸺
亻弋貝	貸贷
臼車廾	輿舆
亻卜貝	偵侦
亻貝刂	側侧
亻見	俔伣
亻丿士貝	賃赁
亻匕頁	傾倾
亻匕貝	貨货
亻言耂	儲储
隹火鳥	鷦鹪
亼口龍	龕龛
食耳	餌饵
食艹日大	饃馍
食十冖子	餑饽
乂木弋工	弒弑
食一屮	飩饨
行金	銜衔
食中一貝	饋馈
食日匕匕	餛馄
食丿士	飪饪
食丿大	飫饫
食手戈	餓饿
食𠂉巾	飾饰
食𠂉力	飭饬
食宀口	餉饷
食臼丨又	餿馊
食𠂆又	飯饭
食爪女	餒馁
食几	飢饥
食𠂊臼	餡馅
食欠	飲饮
食卯田	餾馏
食勹巳	飽饱
亼㇕口頁	頷颔
亼㇕貝	貪贪
食䒑廾	餅饼
食羊彐丨	饈馐
食宀㠯	館馆
食虫	蝕蚀
食㇆一口	飼饲
八刀頁	頒颁
八刀貝	貧贫
八厶頁	頌颂
食厶口	飴饴
金一廾	鈃钘
金丁	釘钉
金耂丂	銬铐
金耂	鍺锗
金耂匕	銠铑
金丰寸	鋳铸
金耳	鉺铒
金丰月	錆锖
金王丶	鈺钰
金甘	鉗钳
金十	針针
金十口	鈷钴
金廿日	錯错
金艹隹又	鑊镬
金木一	鉢钵
金甫	鋪铺
金雨田	鐳镭
金木丶	鉥𬬸
金大十廾	錛锛
金𠂇月	銪铕
金大丶	钛鈦
金一日小	鐐镣
金犬㇕	鈸钹
金至	銍铚
金弋	釴𬬩
金戊㇆	鋮铖
金弋心	鋱铽
金之車	鏈链
金匚	鉅钜
金戈乚	鉞钺
金卜	釙钋
金圍大	銦铟
金圍十口	錮锢
金口月	鋗𫓶
金日一	鉭钽
金田土	鋰锂
金刂	釗钊
金田木	錁锞
金田	鈿钿
金小貝	鎖锁
金小丿	鈔钞
金小月	銷销
金业半大	鏷镤
金小口土	鏜镗
金冂一口	銅铜
金冂人	鈉钠
金貝	鋇钡
金目	鉬钼
金且力	鋤锄
金牛口	鋯锆
金千日二	鍾锺
金千臼	鍤锸
金牛儿	銑铣
金禾火	鍬锹
金禾刀㇆	銹锈
金厂三殳	鍛锻
金白王	鍠锽
金川	釧钏
金自木	鎳镍
金隹	錐锥
金白	鉑铂
金白巾	錦锦
金人王	銓铨
金斤	釿𬬱
金人人土	銼锉
金亼㇕	鈐钤
金亼龴	鈴铃
金爪𠂇又	鍰锾
金彡	釤钐
金𠂆又	鈑钣
金凡	釩钒
金几口	鉛铅
金夂丰	鋒锋
金夕口	銘铭
金卯	鉚铆
金欠	欽钦
金勹丶	釣钓
金勹冫	鈞钧
金勹厶	鈎钩
金辛	鋅锌
金立日儿	鏡镜
金亠巾	鈰铈
金衣	銥铱
金亠冖方	鎊镑
金丶艮	鋃锒
金方	鈁钫
金广廿又	鍍镀
金門木四	鑭镧
金門	鍆钔
金广刂八	鐮镰
金羊大	鎂镁
金八口儿	銳鋭锐
金䒑业日	鐠镨
金火	鈥钬
金火火	錟锬
金八弓亻	銻锑
金儿⺍	銚铫
金宀一止	錠锭
金心丿	鉍铋
金尸十口	鋸锯
金皮	鈹铍
金艮	銀银
金尸匕	鈮铌
金又丶	釵钗
金召	鉊𬬿
金子皿	錳锰
金弓刂貝	鐨镄
金了	釕钌
金廴彐キ	鍵键
金女口	銣铷
金巛田	錙锱
金女	釹钕
金母	鉧𬭁
月龍	朧胧
犭貝	狽狈
風目廾	颶飓
風臼丨又	颼飕
風勹巳	颮飑
月月鳥	鵬鹏
九鳥	鳩鸠
犭言犬	獄狱
月半魚	鰧䲢
月半馬	騰腾
魚一日乂	鯁鲠
魚干八	鮃鲆
魚土土	鮭鲑
魚士口	鮚鲒
魚土八夂	鯪鲮
魚耂匕日	鰭鳍
魚丰日	鰆䲠
魚丰月	鯖鲭
魚耳又	鯫鲰
魚十艹貝	鱝鲼
魚廿乚木	鰈鲽
匕十鳥	鴇鸨
魚革力	鰳鳓
魚雨彐	鱈鳕
魚而	鮞鲕
匕頁	頃顷
魚𠂇月	鮪鲔
魚尤	魷鱿
魚厂屮欠	鱖鳜
魚之車	鰱鲢
魚卜口	鮎鲇
魚圍十口	鯝鲴
魚田土	鯉鲤
魚非	鯡鲱
魚日日	鯧鲳
魚日四又	鰻鳗
魚日匕匕	鯤鲲
魚日	魯鲁
魚田心	鰓鳃
魚日习习	鰨鳎
魚用口	鯛鲷
魚冂一口	鮦鲖
魚四水	鰥鳏
鳥山	島岛
𠂊貝	負负
𠂊用甲一	觯觶
魚禾	穌稣
匕禾頁	穎颖
魚禾火	鰍鳅
魚丿糸	鯀鲧
魚白王	鰉鳇
魚亻寸	鮒鲋
魚臼儿	鯢鲵
魚爪午凵	鰩鳐
鳥几	鳧凫
魚勹巳	鮑鲍
魚方	魴鲂
魚羊	鮮鲜
魚八酉寸	鱒鳟
魚米夕㐄	鱗鳞
魚羊䒑口	鱔鳝
魚宀一兀	鯇鲩
鳥宀匕	鴕鸵
魚艮卩	鯽鲫
魚刀	魛鱽
夕卩鳥	鴛鸳
烏	烏乌
鳥木	梟枭
魚厶口	鮐鲐
言丁一	訏𬣙
言丁	訂订
言丁口	訶诃
言干八	評评
言土土	詿诖
言土寸	詩诗
言工	訌讧
言士口	詰诘
言耂	諸诸
言工人人	誣诬
言耒	誄诔
言丰月	請请
言耳又	諏诹
言寸	討讨
言十	計计
言甘木	謀谋
言廿乚木	諜谍
言艹𠂇口	諾诺
言十口	詁诂
言艹亡川	謊谎
言甘匚八	諶谌
言西土	諲𬤇
言西日十	譚谭
言木四	諫谏
言豕	諑诼
言𠂇火	詼诙
言弋工	試试
言匚王	誆诓
言戈廾	誡诫
言牙	訝讶
言旡旡日	譖谮
言戊㇆	誠诚
言匚	詎讵
言卜	訃讣
言虎匚一	謔谑
言口一大	誤误
亠圍一頁	顫颤
亡口貝凡	贏赢
言非	誹诽
言田木	課课
言日四又	謾谩
言田八夂	謖谡
言小月	誚诮
言田月	謂谓
言且	詛诅
言冂口	詗诇
言冂一口	詷𫍣
言山	訕讪
言冂人	訥讷
言午	許许
言舌	話话
言牛口	誥诰
言𠂉木	誅诛
立丿彡頁	顔颜
言禾刀㇆	誘诱
言𠂉母	誨诲
言川	訓训
言隹	誰谁
言隹火	譙谯
言亼月刂	諭谕
言人王	詮诠
言人非一	讖谶
言人彡	診诊
言𠂆一口	詬诟
言斤	訢䜣
言爪午凵	謡谣
言犭王	誑诳
亠几頁	頏颃
言風	諷讽
言𠂊厂卩	詭诡
言勹日	詢询
言匕日	詣诣
言𠂊臼	諂谄
言匕匕白	諧谐
言氏丶	詆诋
言𠂊尹	諍诤
言亠口小	諒谅
言立日	諳谙
言立丿彡	諺谚
辛言辛	辯辩
言亠冖巾	諦谛
言亠冖方	謗谤
言方	訪访
文門木四	斕斓
言羊	詳详
言䒑八皿	謚谥
言火火	談谈
言之米	謎谜
言䒑刂八	謙谦
言冖車	諢诨
言之一㠯	譴谴
言宀且	誼谊
言宀丿七	詫诧
言㇕大	訣诀
言皮	詖诐
言龴用	誦诵
言㇆一口	詞词
言乙十	訊讯
言召	詔诏
言廴丿止	誕诞
言刀丶	訒讱
言巳	記记
言厶口	詒诒
亠丩人頁	頦颏
辛糸辛	辮辫
門土土	閨闺
門三	閆闫
冫馬	馮冯
疒木𠂊貝	癩癞
門木四	闌阑
广車	庫库
門大申	閹阉
广龍	龐庞
門戈口一	閾阈
門圍木	閫阃
門甲	閘闸
門日日	閶阊
門一	閂闩
門王	閏闰
門木	閑闲
門虫	閩闽
門言	誾訚
門馬	闖闯
門亻戈	閥阀
門人	閃闪
門爪冖又	閿阌
疒風	瘋疯
冫欠貝	資资
門𠂊臼	閻阎
疒魚羊	癬癣
門亠几	閌闶
門亠丩人	閡阂
門八口儿	閱閲阅
門氵舌	闊阔
門心	悶闷
門癶一大	闋阕
門㇕耳攵	闞阚
疒阝彐心	癮瘾
心長	悵怅
羊魚	鯗鲝
心十艹貝	憤愤
心木𠂊貝	懶懒
火頁	煩烦
心車斤	慚惭
心門文	憫悯
火門心	燜焖
心冖車	惲恽
八弓亻鳥	鵜鹈
心母貝	慣惯
氵工鳥	鴻鸿
氵丰貝	漬渍
氵龍	瀧泷
氵車斤	漸渐
氵之車	漣涟
氵卜貝	湞浈
氵貝	浿𬇙
氵魚	漁渔
氵門王	潤润
氵門木四	瀾澜
氵門日	澗涧
氵冖車	渾浑
⺍冖見	覚觉
氵弓長	漲涨
氵糸隹	濰潍
宀甘八貝	賽赛
宀甘八馬	騫骞
宀龍	寵宠
示卜貝	禎祯
之中一貝	遺遗
示見	視视
冖隹鳥	鶴鹤
宀夂口頁	額额
示馬	禡祃
衤广車	褲裤
馬丰石	騞𬴃
馬耳又亻	驟骤
馬甘廾	騏骐
馬大丁口	騎骑
馬大	馱驮
馬匚乂	駆驱
馬圍大	駰骃
馬口乂	駛驶
馬非	騑𬴂
馬田木	騍骒
馬田糸	騾骡
馬且	駔驵
馬冂口	駉𬳶
馬四	駟驷
馬川	馴驯
馬隹	騅骓
馬丿夂心	驄骢
馬乂乂	駁驳
馬勹口	駒驹
馬夂口	駱骆
馬卯田	騮骝
馬丶王	駐驻
馬辛	騂骍
馬衣口甘	驤骧
馬亠丩人	駭骇
馬北艹廾	驥骥
馬䒑廾	駢骈
馬宀匕	駝驼
馬户习习	騸骟
予頁	預预
馬又	馭驭
馬馬馬	驫骉
馬尸子子	驏骣
馬也	馳驰
馬厶口	駘骀
馬厶八夂	駿骏
阝龍	隴陇
阝車	陣阵
力口貝	賀贺
力口馬	駕驾
糸丁一	紆纡
糸士口	結结
糸耂	緒绪
糸土八夂	綾绫
糸二厶	紜纭
糸丰月	綪𬘬
糸丰阝	綁绑
糸寸	紂纣
糸甘	紺绀
糸革	緙缂
糸廿乚	紲绁
糸甫寸	縛缚
糸木木	綝𬘭
糸木目	緗缃
糸辰寸	縟缛
糸一自圍	緬缅
糸戊一口	緘缄
糸至	絰绖
糸卜日十	綽绰
糸口耳	緝缉
糸圍大	絪𬘡
糸口月	絹绢
糸非	緋绯
糸日四又	縵缦
糸小丿	紗纱
糸小月	綃绡
糸日一止	緹缇
糸田糸	縲缧
糸用口	綢绸
糸冂口	絅䌹
糸貝貝女	纓缨
糸冂人	納纳
糸丿士	紝纴
糸牛儿貝	纘缵
女馬	媽妈
糸禾刀㇆	綉绣
糸厂三殳	緞缎
糸川	紃𬘓
糸隹	維维
糸白巾	綿绵
糸白方攵	繳缴
糸亼口	給给
糸人二厶	絵绘
糸行	絎绗
糸八刀	紛纷
糸爪𠂇又	緩缓
糸爪女	綏绥
糸丸	紈纨
糸氏	紙纸
糸夂卜口	綹绺
糸夂口	絡络
糸勹日	絢绚
糸勹丶	約约
糸夂冫	終终
糸𠂊巴	絶绝
糸文	紋纹
糸方	紡纺
女門木	嫻娴
糸半	絆绊
糸八四日	繒缯
糸羊䒑口	繕缮
糸米乚	継继
糸宀示	綜综
糸宀一止	綻绽
糸宀一白	縮缩
糸之夂丰	縫缝
糸宀㠯	綰绾
糸彐丨	紐纽
糸彐水	緑绿
糸予	紓纾
糸弓丨	紖纼
糸召	紹绍
母貝	貫贯
糸刀又	級级
糸弓刂	紼绋
糸刀丶	紉纫
糸巳	紀纪
糸彑豕	緣缘
糸丩	糾纠
糸厶口	紿绐
糸巛田木	繅缫
一口丁鳥	鷊鹝
一夕甲一	殫殚
一夕刂鳥	鴷䴕
工貝	貢贡
工人人見	覡觋
工人人鳥	鵐鹀
土口貝	塤埙
土火卜貝	赬赪
土烏	塢坞
士冖車殳	轂毂
耳中一貝	聵聩
丰貝力	勣𪟝
丰力攵貝	贅赘
丰力攵魚	鰲鳌
丰力攵馬	驁骜
丰月鳥	鶄䴖
王小貝	瑣琐
王牛儿貝	瓚瓒
王爪𠂇又	瑗瑷
王冖車	琿珲
扌士口頁	擷撷
扌貝貝女	攖撄
扌金欠	撳揿
扌鳥山	搗捣
扌母貝	摜掼
廿口丰見	覲觐
艹一廾刂	荊荆
廿日鳥	鵲鹊
廿乚貝力	勩勚
甘冂土見	覯觏
十艹貝	賁贲
十口鳥	鴣鸪
十口月鳥	鶘鹕
十又頁	頍𫠆
十冖子鳥	鵓鹁
艹戊貝	蕆蒇
艹止癶頁	蘋𬞟
艹中一貝	蕢蒉
艹口隹鳥	鸛鹳
艹魚刂	薊蓟
艹魚羊	蘚藓
艹予頁	蕷蓣
艹糸工	葒荭
甫鳥	鵏𬷕
木西貝	檟槚
木卜貝	楨桢
木貝貝女	櫻樱
木人人	來枞
木言耂	櫧槠
雨言勹亡	靄霭
木糸彑豕	櫞橼
石丰貝	磧碛
一火小鳥	鷯鹩
大申鳥	鵪鹌
而鳥	鴯鸸
龍耳	聾聋
龍艹廾	龔龚
豕十艹貝	豶豮
臣丰貝	賾赜
車丰一大	輳辏
車丁口	軻轲
車大	軑轪
車兀	軏𫐄
車厂卩	軛轭
車亠口小	輬辌
車一口田	輻辐
車予丿木	輮𫐓
車手丶	軼轶
車臼儿	輗𫐐
車人彡	軫轸
車斤	斬斩
車斤木	槧椠
車舟	輈辀
車氏	軝𬨂
車夂口	輅辂
車八酉	輶𬨎
車又又又	輟辍
匚車九	匭匦
匚日女鳥	鶠𬸘
戈	戈戋
戈刂	划刬
匚乂鳥	鴎鸥
弋鳥	鳶鸢
卜口見	覘觇
卜圍羊工	鹺鹾
虎业見	覷觑
止癶鬼十	顰颦
止匕魚	鮆𫚖
齒大丁口	齮𬺈
齒丿冂厶	齲龋
齒足	齪龊
齒且	齟龃
齒𠂉乙	齕龁
齒臼儿	齯𫠜
齒人刂	齘𬹼
齒斤	齗龂
齒匕	齔龀
齒艮	齦龈
齒召	齠龆
口丂鳥	鴞鸮
口工貝	嗊唝
足夂口鳥	鷺鹭
口口頁口	囂嚣
口口丂鳥	鶚鹗
口小貝	嗩唢
口貝貝女	嚶嘤
口冂人	吶呐
口貝力	勛勋
口烏	嗚呜
日冂厶頁	顒颙
日勹亡鳥	鶡鹖
日亠小頁	顥颢
巾⺍攵魚	鱉鳖
目犬鳥	鶪䴗
四革馬	羈羁
山大車	輋𪨶
山見	峴岘
山金欠	嶔嵚
貝用口	賙赒
貝貝午凵	罌罂
貝辰	賑赈
貝冖二目	賵赗
貝貝貝	贔赑
貝丿之	貶贬
貝人示	賒赊
貝𠂊八言	贍赡
貝厶口	貽贻
貝亠丩人	賅赅
貝貝女鳥	鸚鹦
骨鳥	鶻鹘
牛儿貝阝	酇酂
廴丿士頁	頲颋
竹丰貝	簀箦
竹木𠂊貝	籟籁
禾火鳥	鶖鹙
舌鳥	鴰鸹
竹中一貝	簣篑
竹口貝	篔筼
隹言隹	讎雠
鬼十鳥	鵯鹎
鬼一人人	魎魉
亼口頁	頜颌
亼口鳥	鴿鸽
亼月刂見	覦觎
亼龴鳥	鴒鸰
行鳥	鸻鵆
八人口鳥	鵒鹆
食巳艹廾	饌馔
食木口	餗𫗧
食廿口丰	饉馑
食亠日一	饘𫗴
食日四又	饅馒
食亠八乂	餃饺
食土厶皿	饁馌
八厶习鳥	鶲鹟
金一廾刂	鉶铏
金一止	鉦钲
金下乚	鈣钙
金一八丁	鎘镉
金丰丰彐	鏏𬭬
金丰刀大	鍥锲
斤頁	頎颀
𠂆虎鳥	鷉䴘
金十⺍丶	銶𨱇
金艹亼口	鎝𨱏
金艹日大	鏌镆
金艹田	錨锚
金艹冂大	鍈锳
金西示	鏢镖
金甫寸	鎛镈
金西日十	鐔镡
釆田鳥	鷭𬸪
金大丁口	錡锜
金一屮	鈍钝
金口一丂	鍔锷
金由	鈾铀
金甲	鉀钾
金日四又	鏝镘
金日匕匕	錕锟
金田心	鍶锶
金四口衤	鐶镮
金貝刂	鍘铡
金四勹虫	鐲镯
金廴丿士	鋌铤
金千艹二	錘锤
金𠂉木	銖铢
金亻コ矢	鍭𬭤
金臼丨又	鎪锼
金亼口	鉿铪
金爪寸	鋝锊
金釆田	鐇𫔍
金匕匕白	鍇锴
金召儿丶	鑱镵
金𠂊巴	銫铯
金卯田	鎦镏
金烏	鎢钨
金衣口甘	鑲镶
金亠冂口	鎬镐
金亠口子	錞𬭚
金立日心	鐿镱
金方𠂉矢	鏃镞
金亠八乂	鉸铰
金亠十口	鏑镝
金亠子攵	鐓镦
金亠厶儿	銃铳
金亠幺	鉉铉
金鹿火	鑣镳
金广尹用	鏞镛
金八酉寸	鐏𨱔
金䒑八皿	鎰镒
金米夕㐄	鏻𬭸
金半卩	錈锩
金䒑幺幺	鎡镃
爪見	覓觅
金宀豕	鎵镓
金宀𠂇厶	鋐𬭎
金穴人口	鎔镕
金宀匕	鉈铊
金宀女	銨铵
金彐丨	鈕钮
金癶口䒑	鐙镫
金予八口	鐍𫔎
金彐冖又	鋟锓
金阝丁口	錒锕
金乙	釔钇
金巴	鈀钯
金弓口虫	鏹镪
金习人彡	鏐镠
舟鳥	鵃鸼
金巛乂巛	鑞镴
風卜口	颭飐
風田心	颸飔
犭王鳥	鵟𫛭
犭木𠂊貝	獺獭
月牛儿貝	臢臜
犭言犬鳥	鸑𬸚
魚士䒑口	鱚𬶮
魚西示	鰾鳔
魚木四	鰊𬶠
𠂊厂卩頁	頠𬱟
卯田鳥	鶹鹠
氏丶鳥	鴟鸱
魚一屮	魨鲀
魚口一丂	鰐鳄
魚日一止	鯷鳀
魚曲口䒑	鱧鳢
魚𠂉匕	鮓鲊
魚䏑又示	鰶𬶭
魚𠂊厂卩	鮠𬶏
魚召儿	鮸𩾃
匕水頁	潁颍
匕火頁	熲颎
魚亠口小	鯨鲸
魚亠日一	鱣鳣
魚亠八乂	鮫鲛
魚广尹⺍	鱇𩾌
魚䒑刂八	鰜鳒
魚儿⺍	鮡𬶐
魚宀匕	鮀𬶍
魚宀女	鮟𩽾
魚龴用	鯒鲬
勹口鳥	鴝鸲
魚习习白	鰼鳛
烏阝	鄔邬
魚厶大彡	鯵鲹
魚巛田	鯔鲻
魚巛乂巛	鱲𫚭
鳥衣	裊袅
言干	訐讦
言一止	証证
言廿口丰	謹谨
言艹日大	謨谟
言一厶心	譓𬤝
言戊一口	諴𫍯
亠圍一鳥	鸇鹯
言口一丂	諤谔
亠口尤鳥	鷲鹫
亠口甲一	嚲亸
亠口子鳥	鶉鹑
言日一止	諟𬤊
言日勹亡	謁谒
言𠂉匕	詐诈
言牛儿	詵诜
言𠂉乙	訖讫
言禾女	諉诿
言身寸	謝谢
言臼人	諛谀
言亻匕	訛讹
言臼丨又	謏𫍲
文一止貝	贇赟
亠八乂鳥	鵁䴔
言亼㇕心	諗谂
言八厶	訟讼
言爪𠂇又	諼谖
言𠂊八言	譫谵
言亠口子	諄谆
言亠人十	誶谇
言亠十口	謫谪
言門木四	讕谰
立日工貝	贛赣贑
言䒑业日	譜谱
立日貝心	戇戆
言户冊	諞谝
言心丿皿	謐谧
言予八口	譎谲
方𠂉矢鳥	鷟𬸦
言习人彡	謬谬
言习习	詡诩
言屮凵	詘诎
疒十廾頁	癲癫
广彐人貝	賡赓
广彐人鳥	鶊鹒
广金欠	廞𫷷
广廿火鳥	鷓鹧
門耂	闍阇
門西土	闉𬮱
門目犬	闃阒
門𠂇厶	閎闳
門口口	閭闾
門十目廾	闐阗
疒貝貝女	癭瘿
門自木	闑𫔶
門方人冫	閼阏
門夂口	閣阁
門氏日	閽阍
門文	閔闵
門丶艮	閬阆
門日习习	闒阘
門土厶皿	闔阖
門䒑屮欠	闕阙
䒑八皿鳥	鷁鹢
䒑彐八鳥	鶼鹣
䒑幺幺鳥	鶿鹚
心中一貝	憒愦
心貝刂	惻恻
氵十艹貝	濆𣸣
氵木𠂊貝	瀨濑
氵止癶頁	瀕濒
氵中一貝	潰溃
氵日小頁	灝灏
氵小丿魚	鯊鲨
⺍人月鳥	鶺鹡
儿⺍頁	頫𫖯
氵言午	滸浒
氵予頁	澦滪
土冖豕	塚塚
宀甘八鳥	鶱𬸣
穴鳥	窵窎
衤門木四	襴襕
衤之車	褳裢
衤冖車	褌裈
冖車皮	皸皲
冖車阝	鄆郓
冖儿鳥	鴆鸩
門木鳥	鷴鹇
馬西示	驃骠
馬雨木目	驦骦
馬不一	駓𬳵
馬厂白小	騵𫘪
馬日一止	騠𫘨
馬日	馹驲
尹口頁	頵𫖳
尸貝	屓屃
馬牛儿	駪𬳽
尸鳥	鳲鸤
尸口辛鳥	鸊鷿䴙
馬亻寸	駙驸
馬亼木	駼𬳿
艮旡魚	鱀𬶨
馬爪幺大	騱𫘬
馬勹午凵	騊𫘦
又又木頁	顙颡
予丿口鳥	鷸鹬
予丿攵鳥	鶩鹜
予丿攵馬	騖骛
馬米夕㐄	驎𬴊
馬癶一大	騤骙
馬㇕大	駃𫘝
馬彐水	騄𫘧
馬又丶虫	騷骚
馬彐冖又	駸骎
阝𠂇月土	墮堕
阝止癶馬	騭骘
阝中一貝	隤𬯎
阝口貝	隕陨
习习彡鳥	鷚鹨
习习冖車	翬翚
糸一业日	縉缙
糸一日乂	綆绠
糸士口頁	纈缬
糸十目廾	縝缜
糸西示	縹缥
糸雨而	繻𦈡
糸大丁口	綺绮
糸一日小	繚缭
糸犬㇕	紱绂
糸𠂇厶	紘纮
糸戈𠂇	絨绒
車糸糸口	轡辔
糸口口木	繰缲
糸之一㠯	繾缱
糸申	紳绅
糸日匕匕	緄绲
糸田心	緦缌
糸四口衤	繯缳
糸目小丿	緲缈
糸四火土	纆𬙊
糸千二火	纁𫄸
女爪𠂇又	媛嫒
糸廴丿止	綖𫄧
女又馬	駑驽
糸𠂉乙	紇纥
糸之丿㠯	縋缒
糸亻コ矢	緱缑
糸乂𠂇巾	絺𫄨
糸八人口	綌绤
糸爪冖又	綬绶
糸勹午凵	綯绹
糸夂㐄	絳绛
糸匕匕	紕纰
糸衣口甘	纕𬙋
糸亠冂口	縞缟
糸亠口子	綧𬘯
糸衣口一	縗缞
糸立日心	繶𫄷
糸亠冂厶	縭缡
糸亠八乂	絞绞
糸亠冖巾	締缔
糸䒑八皿	縊缢
糸䒑刂八	縑缣
糸半卩	綣绻
糸八弓亻	綈绨
糸宀由八	縯𬙂
糸冖儿	紞𬘘
糸又又又	綴缀
糸巳七日	緡缗
糸廴丿士	綎𬘩
糸习人彡	繆缪
糸巛田	緇缁
糸屮凵	絀绌
木刂丶見	榄𬄦
糸口八	织𥿗
木馬	榪杩
雨氵丿士	霪䨙
魚人二厶	𩷆鲙
口口一戈	戰𡃹
艹廿冖巾	𦷾蔕
艹魚禾大	𡚡𫰅
魚由	鮋鲉
糸三田田	繮缰
牛口	告吿
金尸目	鎇镅
日耂	暑暏
氵宀皿丁	濘𬈿
厂車	厙厍
土火見	𧹦䚂
八刀又貝	𪬼𫎤
小冂口	尚尙
巴土八夂	𪩮𱜞
巴土儿夂	𪩮𱜞
木門一廾	𣛣𬂻
扌宀皿丁	𢴕擰
氵廿冖巾	滯𣻉
羊大乚木	𫅠𬙾
匕匕	比𫧇
月門十丿	𦟼𫆝
扌丸	执𢩾
山鬼	嵬㟴
口巾	吊𫩒
艮旡木	槩㮣
竹八田土	𨤰𫒂
𠂊小田土	𨤰𫒂
𠂉小田土	𨤰𫒂
口口一丂	咢㗁
鳥艹隹又	鸌鹱
金月穴工	𨭒𨭏
土尹口羊	𡑳𡑱
口艹夂口	𠺴𡀩
土厶衤甫	𠬖𠬕
子瓜鳥	𪂮𪂲
扌魚日	擼撸
口門木四	㘓𪢌
艹四冖又	𦴋蘉
矢一䒑艮	𥐇𬑶
氵艹冖巾	𤀐滞
亻户小丿	𪝹𫣪
扌日	抇𢪏
木豕	椓㭬
四土亼㇕	𪑑黔
厶人下	𠀳𫠪
口禾彐心	𡅯𪢖
习习立申	𫅮𫅲
金口王	鋥锃
糸亠口小	綡𫟅
車卜尸	𨋤轳
小門十丿	𡮣𡭬𡮥
車田夂口	𨎟𫏾
王廾心	𢚸𪫵
羊大日一	𦏄𫅝
王亠冖巾	𤧛𪼀
人水	汆氽
几二月刂	𩙌𬲂
几二月巛	𩙌𬲂
山𠂉乙	屹𪨣
口耳戈	戢𠺵
扌日甘衤	𢺖𱠻
長彡斤廾	鬂鬓
艹宀皿丁	薴𬞊
户艹廾	𢩉𫼌
艹木口	莕𫇿
士冖殳心	慤愨
扌匕匕	批𢪲
王廾十又	𪔠𲎚
田木𠂊貝	𣡙𣡚
田木刀貝	𣡙𣡚
日卜尸	𣆐𬀭
口艹木四	囒𪢠
日豕耂	𣌁𣌂
門月	閒𫔮
山兀	屼𡵉
日一丂	𣅙𣅘
金廿由八	鐄𨱑
扌业羊寸	𣝉𢷮
口艹口䒑	𠻼𡃻
𠂉木亼冊	𣘈𣜱𪳔
亼冊口貝	𡃋𫭕
食戈	饯𩚧
爪	爪𫜵
几二之艮	𫗂𫗁
四厶匕匕	罷𠤩
火日甘衤	𪹷𬋟
口一夕刂	咧𡂲
一木自圍	𬰠𩈘
亦鳥	鵉𪁂鸾
日广卜口	𣈔𣈘
山日冂厶	嵎𡺥
艹虎一丂	𧃷𬞲
一夕丿皿	殈𬠼
禾厶卜貝	𥢅𥢆
長彡人人	𩯮鬗
月日甘衤	𣎦𦣙
土巳	圯圮𡉏
貝刂寸	𫴯𡬷
金艹廾	鉷𫟹
氵魚日	瀂澛
䒑彐䒑业	𫡁𫡂
門小	𡮉𡭜𨳒
几二刂心	𫗄𫗃
几二巛心	𫗄𫗃
門文キ	𫔳𫔤
户氏	𬇋𣱆
足艹人人	𨅼蹒
尸毛田凵	𡳒𤳰
尸毛由凵	𡳒𤳰
𠂊用八夂	𧤁𧤸
𠂊用儿夂	𧤁𧤸
尸丶耂阝	𡳤𡳢
女厶四貝	𡤓𪦲
厶口亻弋	𠳙𫢼
亻木一見	𧡊𫌠
爿心	𬌔𬌓
扌丿尸丶	𡱩𢭑
火火冖力	勞𤏪
人王亼冊	𠓹𠓻𫤍
魚卜尸	𫙔鲈
夕卜人土	𡎥𫮋
山亠口小	𡹞𡹡
口王	呈㕵
亻八之艮	𠑉𫤈
火門亠巾	𤐛𬊢
門十丿小	𫴼𡮤
一止冂口	𣦎𬆈
艹門木四	蘭𬞕
几言十	𧦔𪞴
人人夕卜	𡎢𡎦
口土卩又	𠼶𠾷
口口耳攵	嚴㘙
風之艮	𩘬𩘩
門一廾	開𫔭
土火耂見	𬦄𧺃
金魚日	鑥镥
金尸㇆口	鋦锔
户习㇕大	𦑗𬚇
矢一口䒑	短𥐍
丿皿卯	𧖰𧖱
木艹木四	欗𬅉
日行亼木	𣉹𬁊
日犭耂	𬁑𪱂
口皿	𠰘𠱄
木口欠	欶𣒱
小門心	𡮮𡮬
卜口刀	𠛤𪟂
刀鳥	鳭𠟀
犭宀皿丁	獰𤡛
田土火火	𨤮𨤵
木艹丶皿	𣞎𣠩
日十十月	𣋂𣊿
氵口貝	溳涢
亼月几二	𫖾𬲇
一巾	巿帀
日牛巾刂	𪰮㫼
木十日一	𬃱𬄮
氵風	渢沨
風	風风
山風	嵐岚
立風	颯飒
月儿⺍	朓脁
亻一人人	倆俩
車一人人	輛辆
日	日曰
户	戶户戸
士冖亞	壺壸壼
穴夫見	窺窥
扌夫夫車	攆撵
金夫	鈇𫓧
亞	亞亚亜
亞心	惡恶悪
口亞	啞哑唖
艹咼	萵莴
虫咼	蝸蜗
金咼	鍋锅
氵咼	渦涡
示咼	禍祸
女咼	媧娲
土咼	堝埚
咼	咼呙
穴咼	窩窝
申	申电
金口口	鋁铝
口口口	品𠴊
口口巴	唈𫶷
亞土	堊垩
女亞	娅婭
示一口田	福福
示申	神神
示羊	祥祥
木亞	椏桠
口亞心	噁𫫇
气亞	氬氩
一夕非一	殲殱
爲	為爲为
艹爲	蒍蔿𫇭
亻爲	偽僞伪
氵爲	溈潙沩
女爲	媯妫
扌爲	撝㧑
舟皿八夂	𥃑𪾝
糸糸	絲丝
糸糸鳥	鷥鸶
夕卩	夗夘
言丿屮	𧦖訰
厂日厶口	𠫆𪠗
禾八口儿	稅税
月八口儿	脫脱
虫八口儿	蛻蜕
八口儿	兌兑
心八口儿	悅悦
木八口儿	梲棁
亡心口月	𫡾𫺴
氵婁	漊溇
婁攵	數数
耒婁	耬耧
扌婁	摟搂
木婁	樓楼
口婁	嘍喽
骨婁	髏髅
竹婁	簍篓
亻婁	僂偻
金婁	鏤镂
婁	婁娄
尸行婁	屨屦
尸婁	屢屡
土婁	塿𪣻
扌婁攵	擻擞
艹婁	蔞蒌
艹婁攵	藪薮
虫婁	螻蝼
山婁	嶁嵝
目婁	瞜䁖
月婁	膢𦝼
疒婁	瘻瘘
穴婁	窶窭
衤婁	褸褛
糸婁	縷缕𫃵
長彡婁	𩯁𫙂
尸婁丨日	𡳵𱿈
糸尸婁	𫄎𫄄
婁車	𬧻𫏻
口婁攵	𡂡𪢒
牛婁	𤛠𬌥
亻目廾	俱倶
氵齊	濟济済
齊示	齋斎
齊	齊齐斉
扌齊	擠挤
雨齊	霽霁
足齊	躋跻
亻齊	儕侪
月齊	臍脐
齊刂	劑剂剤
艹齊	薺荠
虫齊	蠐蛴
齊非一	齏齑韲
阝齊	隮𬯀
鬼齊示	𩵃𩴚
方齊	𬀛𪯼
卯貝	貿贸
艹爿士	莊荘
爿士衣	裝装
爿犬	狀状
爿士	壯壮
爿女	妝妆
宀爿冖又	寢寝
廾	廾丌
一廾	亓开
冊	冊册
木冊	柵栅
冊刂	刪删
女冊	姍姗
竹亼刂心	𪬪𬕷
竹女又	笯𪥯
竹亼巛心	𪬪𬕷
爿	片爿
爿釆田	𤗹𬌌
尤	尤尢
糸黽	繩绳縄
穴土黽	竈竃
虫黽	蠅蝇蝿
黽	黽黾
氵黽	澠渑
一兀黽	黿鼋
口口一黽	鼉鼍
黽阝	鄳𫑡
亻黽	僶𠊟
日召儿	晚晩
金𠂊尹	錚铮
齒工㇕口	齬龉
言工㇕口	語语
金工㇕口	鋙铻
木木工㇕	𬃂𬂽
齒二乂口	齬龉
言二乂口	語语
金二乂口	鋙铻
木木二乂	𬃂𬂽
龜	龜龟亀
亻十目	值値
足	足疋
言足月	諝谞
足日一	疍𨀏
齒亼卩	齡齢
乚丩艮阝	鄉郷
馬由丂	騁骋
半巳	𫧟巻
