的	白勹丶
了	了
我	手戈
是	日一止
在	一亻土
和	禾口
有	𠂇月
不	不
就	亠口小尤
都	耂阝
也	也
要	西女
好	女子
他	亻也
去	土厶
到	至刂
還	之四一口衤
上	上
那	刀二阝
人	人
個	亻圍十口
看	手目
中	中
來	木人人
爲	爲
與	臼一乚丨廾
給	糸亼口
等	竹土寸
這	之言
用	用
把	扌巴
下	下
恩	圍大心
能	厶月匕匕
多	夕夕
想	木目心
被	衤皮
地	土也
而	而
一	一
後	行幺夂
又	又
從	行人人止
再	一冂土
將	爿䏑寸
時	日土寸
但	亻日一
過	之咼
打	扌丁
大	大
年	𠂉㐄
以	厶人
買	四貝
讓	言衣口口甘
着	羊目
小	小
得	行日一寸
先	牛儿
或	戈口一
新	立木斤
及	𠂊又
於	方人冫
太	大丶
日	日
才	十丿
可	丁口
比	匕匕
玩	王一兀
最	日耳又
月	月
真	十目廾
並	立立
其	甘廾
話	言舌
請	言丰月
叫	口凵
開	門一廾
出	屮凵
誰	言隹
向	宀口
家	宀豕
問	門口
之	之
更	一日乂
該	言亠凵人
走	走
快	心㇕大
別	口力刂
前	䒑月刂
由	由
高	亠口冂口
裏	衣田土
加	力口
所	户斤
天	一大
已	巳
里	田土
老	耂匕
行	行
事	一中彐
帶	廿儿冖巾
如	女口
死	一夕匕
賣	士四貝
像	亻召豕
使	亻一口乂
剛	冂䒑山刂
成	戊㇕
無	𠂉廿廿火
換	扌𠂊冂八大
只	口八
愛	爪冖心夂
回	圍口
聽	耳王十四一心
少	小丿
元	一兀
喫	口丰刀大
算	竹目廾
者	耂
忙	心亡
起	走巳
各	夂口
分	八刀
則	貝刂
水	水
張	弓長
改	巳攵
三	三
見	見
連	之車
車	車
放	方攵
全	人王
按	扌宀女
萬	艹日冂厶
機	木幺幺戈人
早	日十
拉	扌立
弄	王廾
本	木一
偶	亻日冂厶
頁	頁
進	之隹
性	心生
第	竹弋弓
完	宀一兀
同	冂一口
花	艹亻匕
長	長
女	女
講	言甘冂土
殺	乂木殳
組	糸且
錯	金廿日
些	止匕二
住	亻丶王
名	夕口
次	冫欠
網	糸冂䒑亡
睡	目千艹二
裝	爿士衣
挺	扌廴丿士
王	王
路	足夂口
正	一止
外	夕卜
二	二
頭	一口䒑頁
應	广亻隹心
生	生
心	心
因	圍大
子	子
強	弓厶虫
類	米大頁
作	亻𠂉匕
送	之䒑大
書	彐キ日
每	𠂉母
法	氵土厶
拍	扌白
市	亠巾
撒	扌廿月攵
至	至
接	扌立女
美	羊大
表	丰衤
未	二木
非	非
級	糸𠂊又
即	艮卩
此	止匕
差	羊工
版	爿厂又
併	亻䒑廾
副	一口田刂
系	丿糸
收	凵攵
男	田力
俺	亻大申
字	宀子
股	月殳
轉	車一日厶寸
便	亻一日乂
考	耂丂
塊	土鬼
線	糸白水
手	手
黃	廿一由八
道	之八頁
米	米
座	广人人土
取	耳又
低	亻氏一
難	艹口夫隹
兒	臼儿
受	爪冖又
包	勹巳
阿	阝丁口
喝	口日勹亡
白	白
金	金
四	四
近	之斤
管	竹宀㠯
定	宀一止
傳	亻一日厶寸
門	門
樣	木羊丶水
交	亠八乂
李	木子
笑	竹丿大
自	自
型	一廾刂土
黑	四土火
慢	心日四又
刷	尸巾刂
穿	穴牙
越	走戈乚
位	亻立
貴	中一貝
部	立口阝
選	之巳巳艹廾
牛	牛
怪	心又土
省	小丿目
倒	亻至刂
談	言火火
曾	八四日
累	田糸
汗	氵干
象	召豕
半	半
陳	阝木日
紅	糸工
格	木夂口
五	二乂
幹	十日十人干
方	方
頂	丁頁
某	甘木
條	亻丨攵木
馬	馬
遠	之土口衤
單	口口甲一
海	氵𠂉母
相	木目
熱	土儿土丸火
光	小兀
風	風
且	且
林	木木
額	宀夂口頁
化	亻匕
班	王刂王
滴	氵亠八冂十口
掛	扌土土卜
店	广卜口
安	宀女
坐	人人土
約	糸勹丶
飛	乙冫丿刂乙冫
劉	卯金刂
度	广廿又
種	禾千日二
俄	亻手戈
歌	丁口丁口欠
報	土半卩又
信	亻言
若	艹𠂇口
原	厂白小
文	文
飯	食厂又
晚	日召儿
量	日一田土
村	木寸
式	弋工
空	穴工
山	山
毛	毛
重	千日二
主	丶王
間	門日
裡	衤田土
貼	貝卜口
入	人
伐	亻戈
血	丿皿
盤	舟殳皿
爽	大乂乂乂乂
隊	阝八豕
楊	木日一勿
往	行丶王
片	爿
國	圍戈口一
費	弓刂貝
壞	土衣四水
龍	龍
離	亠乂凵冂厶隹
共	艹廾
西	西
周	用口
超	走召
明	日月
均	土勹冫
期	甘廾月
達	之土羊
照	日召火
切	七刀
留	卯田
動	千日二力
特	牛土寸
氣	气米
係	亻丿糸
神	示申
鳥	鳥
夢	艹四冖夕
教	耂子攵
甘	甘
魚	魚
鎮	金十目廾
罵	四馬
陪	阝立口
既	艮旡
力	力
建	廴彐キ
洗	氵牛儿
口	口
指	扌匕日
東	木日
球	王十⺍丶
活	氵舌
練	糸木日
億	亻立日心
清	氵丰月
提	扌日一止
除	阝亼木
通	之龴用
酒	氵酉
餓	食手戈
票	西示
六	亠八
病	疒一冂人
久	𠂊丶
段	厂三殳
平	干八
套	大長
課	言田木
急	𠂊彐心
藥	艹白幺幺木
城	土戊㇕
任	亻丿士
草	艹日十
羅	四糸隹
理	王田土
令	亼龴
雨	雨
貨	亻匕貝
唱	口日日
左	𠂇工
藍	艹臣𠂉一皿
縣	目木丿糸
常	小冖口巾
色	𠂊巴
菜	艹爪木
集	隹木
感	戊一口心
房	户方
較	車亠八乂
混	氵日匕匕
敢	丁耳攵
火	火
操	扌口口口木
南	十冂半
退	之艮
件	亻牛
破	石皮
德	行十四一心
雪	雨彐
局	尸㇕口
雲	雨二厶
整	木口攵一止
華	華
克	十口儿
現	王見
跳	足儿⺍
養	羊丶艮
補	衤甫
團	圍一日厶寸
沈	氵冖儿
反	厂又
樂	白幺幺木
篇	竹户冊
待	行土寸
深	氵冖儿木
煩	火頁
根	木艮
求	十⺍丶
投	扌殳
電	雨申
親	立木見
惡	亞心
葉	艹廿乚木
款	士示欠
知	矢口
八	八
配	酉巳
器	口口大口口
何	亻丁口
率	亠幺⺍十
調	言用口
鬼	鬼
修	亻丨攵彡
試	言弋工
謝	言身寸
僅	亻艹口丰
層	尸八田日
面	頁圍
週	之用口
北	北
木	木
記	言巳
情	心丰月
肉	䏑
需	雨而
七	七
論	言亼冊
流	氵亠厶川
招	扌召
痛	疒龴用
列	一夕刂
石	石
香	禾日
封	土土寸
眼	目艮
易	日勿
冷	冫亼龴
借	亻廿日
派	氵𠂆亻
帥	丿㠯巾
付	亻寸
十	十
陽	阝日一勿
樹	木士口䒑寸
油	氵由
胡	十口月
排	扌非
停	亻亠口冖丁
合	亼口
軍	冖車
身	身
奧	宀釆大
章	立日十
科	禾冫十
星	日生
翻	釆田习习
場	土日一勿
帖	巾卜口
商	亠八冂儿口
庫	广車
價	亻西貝
物	牛勿
泡	氵勹巳
玉	王丶
追	之丿㠯
傷	亻𠂉日一勿
背	北月
劍	亼口口人人刂
解	𠂊用刀牛
室	宀至
底	广氏一
業	业半木
代	亻弋
孫	子丿糸
朱	𠂉木
亦	大八
須	彡頁
乾	十日十𠂉乙
工	工
詞	言㇕一口
刀	刀
波	氵皮
推	扌隹
落	艹氵夂口
節	竹艮卩
春	丰日
九	九
輸	車亼月刂
江	氵工
短	矢一口䒑
含	亼㇕口
千	千
徐	行亼木
秒	禾小丿
青	丰月
夜	亠亻夂丶
許	言午
吹	口欠
師	丿㠯一巾
板	木厂又
土	土
直	十目
公	八厶
苦	艹十口
秀	禾㇕丿
博	十甫寸
皮	皮
朝	十日十月
君	尹口
詩	言土寸
靜	丰月爪尹
利	禾刂
素	丰糸
立	立
存	一亻子
燒	火土土土兀
吾	二乂口
湯	氵日一勿
民	巳七
極	木丂口又一
命	亼口卩
忘	亡心
茶	艹人木
供	亻艹廾
案	宀女木
田	田
初	衤刀
品	口口口
抽	扌由
造	之牛口
抱	扌勹巳
野	田土予
綠	糸彑水
項	工頁
緊	臣又糸
故	十口攵
服	月卩又
盡	尹一火皿
百	一白
兵	斤廾
英	艹冂大
蘇	艹魚禾
般	舟殳
演	氵宀一由八
果	田木
保	亻口木
唐	广尹口
夏	頁夂
莫	艹日大
硬	石一日乂
寒	宀甘八冫
凡	凡
髮	長彡犬丿
言	言
題	日一止頁
防	阝方
街	行土土
距	足匚コ
挑	扌儿⺍
純	糸丿屮
欲	八人口欠
源	氵厂白小
官	宀㠯
戲	虎一口䒑戈
寄	宀大丁口
古	十口
首	八頁
思	田心
橋	木丿大口冂口
燈	火癶一口䒑
郭	亠口子阝
亮	亠口冖几
干	干
窮	穴身弓
粉	米八刀
爆	火日艹廾水
韓	十日十㐄口㐄
戴	十戈田艹廾
然	䏑犬火
衝	行千日二
雷	雨田
蓋	艹土厶皿
港	氵艹廾巳
租	禾且
狼	犭丶艮
蘭	艹門木日
狂	犭王
布	𠂇巾
引	弓丨
亞	亞
齊	齊
隻	隹又
員	口貝
佛	亻弓刂
食	食
船	舟八口
今	亼㇕
恨	心艮
宋	宀木
銀	金艮
猛	犭子皿
客	宀夂口
友	𠂇又
領	亼龴頁
句	勹口
斯	甘廾斤
沙	氵小丿
戰	口口甲一戈
望	亡月王
沖	氵中
丁	丁
園	圍土口衤
祝	示口儿
鄭	八酉大阝
界	田人刂
抗	扌亠几
步	止癶
河	氵丁口
賊	貝戈𠂇
尚	小冂口
似	亻厶人
羊	羊
福	示一口田
必	弋八
遭	之一曲日
煙	火西土
否	不口
端	立山而
設	言殳
伊	亻尹
秦	丰禾
秋	禾火
毒	丰母
架	力口木
熊	厶月匕匕火
持	扌土寸
廣	广廿由八
折	扌斤
意	立日心
基	甘廾土
困	圍木
圈	圍半卩
迷	之米
勝	月半力
史	口乂
甲	甲
搬	扌舟殳
獲	犭艹隹又
紙	糸氏
乃	㇕丿
右	𠂇口
塔	土艹亼口
準	氵隹十
院	阝宀一兀
訂	言丁
散	廿月攵
松	木人厶
喜	士口䒑口
洋	氵羊
語	言二乂口
呈	口王
治	氵厶口
降	阝夂㐄
峯	山夂丰
漢	氵艹口夫
富	宀一口田
姓	女生
料	米冫十
結	糸士口
閃	門人
梅	木𠂉母
批	扌匕匕
足	足
寧	宀心皿丁
醒	酉日生
精	米丰月
瘦	疒臼丨又
槍	木人户口
軟	車欠
支	十又
杜	木土
麗	一冂丶一冂丶鹿
展	尸廿衤
興	臼冂一口廾
依	亻衣
倍	亻立口
康	广尹⺍
堂	小冖口土
救	十⺍丶攵
鍵	金廴彐キ
製	牛巾刂衣
筆	竹彐キ
音	立日
世	廿乚
著	艹耂
仲	亻中
舞	𠂉廿廿夕㐄
守	宀寸
露	雨足夂口
冒	日目
昇	日丿廾
唄	口貝
榮	火火冖木
弱	弓冫弓冫
影	日亠口小彡
州	⺍川
替	夫夫日
陸	阝土儿土
曲	曲
願	厂白小頁
牙	牙
箱	竹木目
嚇	口土火土火
測	氵貝刂
莊	艹爿士
寬	宀艹見丶
遍	之户冊
細	糸田
狀	爿犬
巴	巴
武	戈止
湖	氵十口月
程	禾口王
柳	木卯
偏	亻户冊
實	宀母貝
印	臼卩
味	口二木
鎖	金小貝
衆	丿皿亻
零	雨亼龴
環	王四一口衤
角	𠂊用
紫	止匕糸
島	鳥山
耶	耳阝
熟	亠口子丸火
孔	子乚
寸	寸
標	木西示
厚	厂日子
答	竹亼口
社	示土
顧	户隹頁
順	川頁
滅	氵戊一火
運	之冖車
輪	車亼冊
兼	禾禾彐
溫	氵圍人皿
娘	女丶艮
登	癶一口䒑
微	行山一几攵
佳	亻土土
瞭	目一火日小
雅	牙隹
魔	广木木鬼
司	㇕一口
志	士心
奇	大丁口
編	糸户冊
瓦	瓦
居	尸十口
盛	戊㇕皿
虎	虎
后	𠂆一口
洞	氵冂一口
台	厶口
形	一廾彡
負	𠂊貝
川	川
圓	圍口貝
充	亠厶儿
害	宀丰口
免	召儿
景	日亠口小
擬	扌匕矢龴足
曹	一曲日
曉	日土土土兀
煮	耂火
良	丶艮
吐	口土
肥	月巴
仙	亻山
宮	宀口丿口
酸	酉厶八夂
侯	亻コ矢
塞	宀甘八土
勁	一巛工力
欠	欠
創	人户口刂
擦	扌宀䏑又示
爾	一八巾乂乂乂乂
藏	艹戈爿臣
皆	匕匕白
永	丶水
夫	夫
琴	王王亼㇕
錄	金彑水
宏	宀𠂇厶
例	亻一夕刂
專	一日厶寸
視	示見
兄	口儿
善	羊䒑口
增	土八四日
施	方𠂉也
淚	氵户犬
暗	日立日
忍	刀丶心
肯	止月
母	母
聖	耳口王
橫	木廿一由八
遊	之方𠂉子
致	至攵
宗	宀示
偉	亻㐄口㐄
麻	广木木
怒	女又心
爭	爪尹
腰	月西女
肖	小月
淨	氵爪尹
罪	四非
仔	亻子
彈	弓口口甲一
丑	彐丨
減	氵戊一口
敏	𠂉母攵
義	羊手戈
棒	木丰キ
臭	自大
響	乚凵艮阝立日
聞	門耳
計	言十
校	木亠八乂
氏	氏
糖	米广尹口
吉	士口
押	扌甲
谷	八人口
衣	衣
宇	宀丁一
雜	亠人人木隹
末	一木
告	牛口
耐	而寸
董	艹千日二
醉	酉亠人人十
妹	女二木
鋼	金冂䒑山
蔣	艹爿䏑寸
幣	巾⺍攵巾
宜	宀且
尼	尸匕
灰	𠂇火
評	言干八
維	糸隹
屋	尸至
幾	幺幺戈人
楚	木木足
館	食宀㠯
丹	冊丶
乘	禾北
認	言刀丶心
刻	亠凵人刂
俊	亻厶八夂
芳	艹方
抄	扌小丿
酷	酉牛口
京	亠口小
嚴	口口厂丁耳攵
返	之厂又
廳	广耳王十四一心
魯	魚日
瑞	王山而
仁	亻二
註	言丶王
添	氵一大心
催	亻山隹
具	目廾
威	戊一女
劇	虎豕刂
核	木亠凵人
農	曲辰
瓶	䒑廾瓦
銅	金冂一口
犯	犭卩
族	方𠂉矢
季	禾子
尋	彐工口寸
顯	日幺幺火頁
骨	骨
黎	禾丿刀人水
騎	馬大丁口
密	宀弋八山
士	士
術	行木丶
祇	示氏
洪	氵艹廾
訊	言乙十
禮	示曲一口䒑
容	穴人口
輝	小兀冖車
射	身寸
智	矢口日
索	十冖糸
燕	廿口北火
撞	扌立田土
膜	月艹日大
普	立立日
竹	竹竹
側	亻貝刂
諾	言艹𠂇口
呂	口丿口
搭	扌艹亼口
鳳	几一鳥
陰	阝亼㇕二厶
薄	艹氵甫寸
涼	氵亠口小
胃	田月
賴	木口刀貝
堆	土隹
赴	走卜
載	十戈車
孟	子皿
抵	扌氏一
彩	爪木彡
甚	甘匚儿
厄	厂卩
粗	米且
傑	亻夕㐄木
慶	鹿㇕心夂
緣	糸彑豕
駐	馬丶王
申	申
衛	行㐄口㐄
訓	言川
念	亼㇕心
惹	艹𠂇口心
帳	巾長
逃	之儿⺍
嘉	士口䒑力口
納	糸冂人
升	丿廾
倉	人户口
休	亻木
症	疒一止
斤	斤
功	工力
浪	氵丶艮
泰	丰水
忠	中心
梁	氵刀八木
吸	口𠂊又
貝	貝
跨	足大丂一
森	木木木
卷	半卩
井	二刂
針	金十
蛇	虫宀匕
寺	土寸
購	貝甘冂土
導	之八頁寸
飲	食欠
噴	口十十十貝
虛	虎丘
優	亻一白冖心夂
埋	土田土
略	田夂口
掃	扌彐冖巾
目	目
蒙	艹冖一豕
託	言丿七
托	扌丿七
巧	工丂
淡	氵火火
拜	手一丰
冬	夂冫
懷	心衣四水
池	氵也
凱	山一口䒑几
鐘	金立田土
愁	禾火心
薩	艹阝立丿生
揚	扌日一勿
勇	龴用力
財	貝十丿
鍊	金木四
終	糸夂冫
質	斤斤貝
泥	氵尸匕
昏	氏日
遇	之日冂厶
喬	丿大口冂口
欄	木門木日
鍋	金咼
巨	匚コ
儀	亻羊手戈
磨	广木木石
呼	口爪丁
賭	貝耂
液	氵亠亻夂丶
泉	白水
嫁	女宀豕
捲	扌半卩
豆	一口䒑
頓	丿屮頁
旺	日王
攻	工攵
祥	示羊
委	禾女
佐	亻𠂇工
臨	臣𠂉口口口
隔	阝一口冂八丁
溝	氵甘冂土
碗	石宀夕卩
賠	貝立口
吻	口勿
健	亻廴彐キ
速	之木口
失	手丶
雄	𠂇厶隹
胸	月勹乂凵
暴	日艹廾水
湊	氵丰一大
陣	阝車
識	言立日戈
娃	女土土
唯	口隹
漏	氵尸雨
拔	扌犬丿
洛	氵夂口
探	扌冖儿木
郎	丶艮阝
珠	王𠂉木
尿	尸水
透	之禾㇕丿
惠	一日厶心
府	广亻寸
父	八乂
耳	耳
搜	扌臼丨又
希	乂𠂇巾
患	中中心
尾	尸毛
播	扌釆田
岩	山石
逗	之一口䒑
賢	臣又貝
限	阝艮
帝	亠八冖巾
昌	日日
模	木艹日大
嫌	女禾禾彐
陶	阝勹午凵
苗	艹田
羽	习习
哩	口田土
稿	禾亠口冂口
棟	木木日
邦	丰阝
玲	王亼龴
驚	艹勹口攵馬
坑	土亠几
備	亻廿丿用
袋	亻弋衣
妖	女丿大
錦	金白巾
琳	王木木
乙	乙
伴	亻半
尊	八酉寸
霜	雨木目
沿	氵八口
伯	亻白
盜	氵欠皿
浩	氵牛口
剩	禾北刂
域	土戈口一
祖	示且
肺	月亠巾
附	阝亻寸
制	牛巾刂
玄	亠幺
置	四十目
豪	亠口冖豕
恆	心二𠂊冫
助	且力
幽	幺幺山
欣	斤欠
辣	辛木口
煤	火甘木
瓜	瓜
諸	言耂
慧	丰丰彐心
墨	田土火土
鮮	魚羊
鏡	金立日儿
蝦	虫尸二コ又
犬	犬
鵬	月月鳥
誠	言戊㇕
賀	力口貝
險	阝亼口口人人
飾	食𠂉巾
炎	火火
震	雨辰
鋒	金夂丰
遂	之八豕
軒	車干
控	扌穴工
覆	西行𠂉日夂
禁	木木示
盃	不皿
童	立田土
徵	行山一王攵
杯	木不
晴	日丰月
魂	二厶鬼
益	䒑八皿
庭	广廴丿士
肝	月干
濃	氵曲辰
坊	土方
晨	日辰
紀	糸巳
振	扌辰
割	宀丰口刂
敗	貝攵
消	氵小月
兆	儿⺍
楓	木風
隆	阝夂一生
撤	扌亠厶月攵
粥	弓米弓
馨	士尸殳禾日
誤	言口乚廾
滑	氵骨
暖	日爪一𠂇又
己	巳
止	止
柱	木丶王
塗	氵亼木土
妻	一尹女
盾	𠂆十目
奔	大十艹
潤	氵門王
政	一止攵
刺	木冂刂
冠	冖一兀寸
蓮	艹之車
獸	口口田一口犬
婚	女氏日
攝	扌耳耳耳
閣	門夂口
敬	艹勹口攵
潮	氵十日十月
昂	日匕卩
飽	食勹巳
邪	牙阝
促	亻足
葛	艹日勹亡
串	中中
桑	又又又木
苑	艹夕卩
迎	之匕卩
弓	弓
碎	石亠人人十
余	亼木
承	㇕水三
迪	之由
烏	烏
臣	臣
勤	艹口丰力
蒸	艹㇕水一火
凌	冫土儿夂
辛	辛
旗	方𠂉甘廾
妙	女小丿
始	女厶口
符	竹亻寸
倫	亻亼冊
亭	亠口冖丁
云	二厶
研	石一廾
俗	亻八人口
啓	户攵口
霧	雨予丿夂力
珍	王人彡
卓	卜日十
積	禾丰貝
捧	扌丰キ
鳴	口鳥
簡	竹門日
罰	四言刂
晃	日小兀
斜	亼木冫十
預	予頁
尤	尤
洲	氵⺍川
乎	爪丁
湘	氵木目
罷	四厶月匕匕
軸	車由
翔	羊习习
異	田艹廾
枝	木十又
逸	之召儿
鴨	甲鳥
染	氵九木
餅	食䒑廾
粘	米卜口
藝	艹土儿土丸二厶
鴻	氵工鳥
腎	臣又月
撲	扌业半大
晶	日日日
勾	勹厶
戒	戈廾
桂	木土土
朗	丶艮月
堵	土耂
荷	艹亻丁口
畝	亠田𠂊丶
私	禾厶
擊	車凵殳手
貸	亻弋貝
傾	亻匕頁
鼓	士口䒑十又
霞	雨尸二コ又
皇	白王
企	人止
互	一彑
柏	木白
騰	月半馬
焦	隹火
潔	氵丰刀糸
盟	日月皿
延	廴丿止
柔	予丿木
資	冫欠貝
粒	米立
嶺	山亼龴頁
盆	八刀皿
檢	木亼口口人人
護	言艹隹又
眉	尸目
傘	人人人人人十
碧	王白石
籍	竹耒廿日
勿	勿
汁	氵十
冊	冊
銘	金夕口
浴	氵八人口
翼	习习田艹廾
哲	扌斤口
菌	艹圍禾
敵	亠八冂十口攵
桶	木龴用
抹	扌一木
判	半刂
寵	宀龍
紋	糸文
弟	弋弓
衰	衣口一
叔	上小又
肩	户月
殿	尸艹廾殳
番	釆田
旭	九日
訪	言方
勢	土儿土丸力
蒐	艹鬼
航	舟亠几
萊	艹木人人
旅	方𠂉亻
鷹	广亻隹鳥
赤	土火
技	扌十又
韻	立日口貝
摘	扌亠八冂十口
翠	习习亠人人十
孝	耂子
移	禾夕夕
搖	扌䏑午凵
畢	甲艹二
予	予
岳	丘山
融	一口冂八丁虫
棋	木甘廾
採	扌爪木
扶	扌夫
介	亻八
渡	氵广廿又
芯	艹心
奪	大隹寸
采	爪木
乳	爪子乚
拳	半手
浜	氵斤廾
錫	金日勿
淫	氵爪丿士
職	耳立日戈
宅	宀丿七
掌	小冖口手
培	土立口
莉	艹禾刂
損	扌口貝
握	扌尸至
謀	言甘木
廟	广十日十月
孤	子瓜
壯	爿士
規	夫見
頗	皮頁
宣	宀二日
尖	小大
討	言寸
漸	氵車斤
耗	耒毛
息	自心
伍	亻二乂
壽	士㇕工一口寸
逢	之夂丰
桃	木儿⺍
壁	尸口辛土
漆	氵木人水
暫	車斤日
虹	虫工
丸	丸
券	半刀
縫	糸之夂丰
俱	亻目廾
菊	艹勹米
奴	女又
岸	山厂干
凝	冫匕矢龴足
芝	艹之
脈	月𠂆亻
烈	一夕刂火
貪	亼㇕貝
婆	氵皮女
蝶	虫廿乚木
誇	言大丂一
枕	木冖儿
毀	臼土殳
避	之尸口辛
浮	氵爪子
枚	木攵
材	木十丿
賞	小冖口貝
翁	八厶习习
幻	幺㇕
固	圍十口
耀	小兀习习隹
槽	木一曲日
穴	穴
幅	巾一口田
審	宀釆田
斬	車斤
伸	亻申
悲	非心
萌	艹日月
斑	王文王
牽	亠幺冖牛
屈	尸屮凵
怨	夕卩心
恐	工凡心
凍	冫木日
複	衤𠂉日夂
柴	止匕木
逆	之䒑屮
僞	亻爲
騷	馬又冫虫
熙	臣巳火
忽	勿心
津	氵彐キ
胎	月厶口
糧	米日一田土
譜	言立立日
准	冫隹
摩	广木木手
縮	糸宀亻一白
漫	氵日四又
溜	氵卯田
棄	亠厶廿木
扇	户习习
憂	一白冖心夂
墓	艹日大土
鹿	鹿
彬	木木彡
卿	丿凵艮卩
鶴	冖隹鳥
函	丂⺍凵
確	石冖隹
郡	尹口阝
奈	大示
茂	艹戊
緩	糸爪一𠂇又
協	十力力力
債	亻丰貝
肌	月几
薰	艹千四二火
映	日冂大
鼻	自田廾
育	亠厶月
候	亻丨コ矢
堅	臣又土
閉	門十丿
決	氵㇕大
適	之亠八冂十口
策	竹木冂
藤	艹月半水
雁	厂亻隹
俠	亻大人人
腸	月日一勿
窄	穴𠂉匕
昨	日𠂉匕
務	予丿夂力
爪	爪
拷	扌耂丂
汝	氵女
撮	扌日耳又
幸	土半
醬	爿䏑寸酉
舟	舟
訴	言斤丶
態	厶月匕匕心
繡	糸尹爿一爿
蜜	宀弋八虫
漂	氵西示
序	广予
巷	艹廾巳
梨	禾刂木
舌	舌
腹	月𠂉日夂
蟹	𠂊用刀牛虫
陷	阝𠂊臼
捉	扌足
蒼	艹人户口
疑	匕矢龴足
鼎	目爿爿
釣	金勹丶
慌	心艹亡川
彼	行皮
辰	辰
執	土半丸
忌	巳心
踏	足水日
捷	扌一彐止
腫	月千日二
縱	糸行人人止
伏	亻犬
壇	土亠圍口日一
默	田土火犬
懸	目木丿糸心
悟	心二乂口
頻	止癶頁
帽	巾日目
幼	幺力
旋	方𠂉足
擁	扌亠乚凵隹
猶	犭八酉
席	广廿巾
叉	又丶
繫	車凵殳糸
妃	女巳
典	冊廾
贈	貝八田日
儒	亻雨而
裸	衤田木
奉	丰キ
御	行午止卩
腔	月穴工
突	穴大
刑	一廾刂
痕	疒艮
賓	宀一癶貝
午	午
蕾	艹雨田
臟	月艹戈爿臣
宰	宀辛
弘	弓厶
境	土立日儿
拒	扌匚コ
毅	立豕殳
煎	䒑月刂火
弦	弓亠幺
蓉	艹穴人口
憶	心立日心
卵	卯丶丶
遷	之西大巳
尺	尸丶
禍	示咼
垂	千艹二
郵	千艹二阝
惜	心廿日
浦	氵甫
警	艹勹口攵言
揭	扌日勹亡
逐	之豕
謂	言田月
昭	日召
宿	宀亻一白
統	糸亠厶儿
裂	一夕刂衣
僧	亻八田日
慣	心母貝
彪	虎彡
淋	氵木木
束	木口
仕	亻士
劫	土厶力
拓	扌石
疊	田田田冖且
律	行彐キ
株	木𠂉木
砂	石小丿
斗	冫十
坪	土干八
揮	扌冖車
箇	竹圍十口
吞	一大口
亡	亡
遙	之䏑午凵
牧	牛攵
兜	白卯儿
監	臣𠂉一皿
稀	禾乂𠂇巾
恰	心亼口
朕	月䒑大
淑	氵上小又
慕	艹日大心
疏	足亠厶川
膏	亠口冖口月
陵	阝土儿夂
纏	糸广田土八土
驗	馬亼口口人人
廷	廴丿士
糊	米十口月
儲	亻言耂
楠	木十冂半
蚊	虫文
祭	䏑又示
拾	扌亼口
朋	月月
芸	艹二厶
吟	口亼㇕
筒	竹冂一口
丘	丘
責	丰貝
堯	土土土兀
繁	𠂉母攵糸
坦	土日一
穗	禾一日厶心
紗	糸小丿
屯	丿屮
虐	虎匚一
紹	糸召
惟	心隹
幕	艹日大巾
遮	之广廿火
庚	广彐人
哉	十戈口
涉	氵止癶
賦	貝戈止
敷	甫方攵
禪	示口口甲一
習	习习白
臥	臣人
釘	金丁
丙	一冂人
歷	厂禾禾止
躍	足习习隹
署	四耂
範	竹車卩
示	示
嵐	山風
夕	夕
議	言羊手戈
趣	走耳又
杭	木亠几
疾	疒矢
崇	山宀示
婦	女彐冖巾
裕	衤八人口
嘆	口艹口夫
艦	舟臣𠂉一皿
荒	艹亡川
貞	卜貝
筋	竹月力
鈴	金亼龴
帆	巾凡
奎	大土土
駕	力口馬
阻	阝且
享	亠口子
棚	木月月
傲	亻土方攵
欽	金欠
召	召
徒	行走
脂	月匕日
競	立口儿立口儿
靖	立丰月
奏	丰一大
盲	亡目
姿	冫欠女
賜	貝日勿
湧	氵龴用力
栽	十戈木
述	之木丶
籠	竹龍
甫	甫
佑	亻𠂇口
閥	門亻戈
咽	口圍大
袖	衤由
貧	八刀貝
激	氵白方攵
階	阝匕匕白
珊	王冊
植	木十目
占	卜口
鉛	金八口
灘	氵艹口夫隹
災	巛火
暢	申日一勿
詠	言丶水
桐	木冂一口
謙	言禾禾彐
万	一力
織	糸立日戈
蒲	艹氵甫
芽	艹牙
昊	日一大
轟	車車車
碑	石鬼十
燃	火䏑犬火
輔	車甫
暉	日冖車
朴	木卜
碩	石頁
杖	木一乂
謎	言之米
刃	刀丶
墜	阝八豕土
衡	行𠂊田大
櫻	木貝貝女
窯	穴羊火
措	扌廿日
眠	目巳七
途	之亼木
叢	业半耳又
禾	禾
磁	石䒑幺幺
沃	氵丿大
哀	衣口
浸	氵彐冖又
柄	木一冂人
輯	車口耳
凸	圍冂
遼	之一火日小
宴	宀日女
堪	土甘匚儿
麟	鹿米夕㐄
祿	示彑水
崩	山月月
醜	酉鬼
革	革
憲	宀丰四心
遺	之中一貝
喚	口𠂊冂八大
刊	干刂
裁	十戈衣
郁	𠂇月阝
逝	之扌斤
際	阝䏑又示
誌	言士心
崖	山厂土土
廉	广禾禾彐
獅	犭丿㠯一巾
鞍	革宀女
墳	土十艹貝
巫	工人人
虞	虎口乚廾
拐	扌口刀
築	竹工凡木
剝	彑水刂
披	扌皮
削	小月刂
悠	亻丨攵心
凹	圍凵
葬	艹一夕匕廾
侃	亻口川
授	扌爪冖又
卸	午止卩
頌	八厶頁
慈	䒑幺幺心
纖	糸人人戈非一
馳	馬也
鞭	革亻一日乂
危	𠂊厂卩
襲	龍衣
泊	氵白
喉	口亻コ矢
溶	氵穴人口
撫	扌𠂉廿廿火
媛	女爪一𠂇又
察	宀䏑又示
駿	馬厶八夂
憐	心米夕㐄
昆	日匕匕
醇	酉亠口子
橙	木癶一口䒑
暮	艹日大日
祕	示弋八
薪	艹立木斤
巢	巛田木
淵	氵爿一爿
愚	日冂厶心
堤	土日一止
傍	亻亠八冖方
燥	火口口口木
漁	氵魚
茜	艹西
允	厶儿
杏	木口
畔	田半
豹	豸勹丶
澄	氵癶一口䒑
冥	冖日亠八
媒	女甘木
燦	火卜夕又米
枯	木十口
軌	車九
塑	䒑屮月土
卜	卜
構	木甘冂土
茅	艹予丿
鑄	金士㇕工一口寸
雀	小隹
亨	亠口了
詳	言羊
腐	广亻寸䏑
皓	白牛口
央	冂大
据	扌尸十口
栓	木人王
輩	非車
卑	鬼十
誓	扌斤言
蜂	虫夂丰
勺	勹丶
迅	之乙十
虫	虫
恥	耳心
匹	匚儿
仰	亻匕卩
羞	羊彐丨
注	氵丶王
瞳	目立田土
黛	亻弋田土火
拂	扌弓刂
挨	扌厶矢
綱	糸冂䒑山
茨	艹冫欠
夷	大弓
慎	心十目廾
汽	氵气
恭	艹廾心
弊	巾⺍攵廾
旦	日一
祁	示阝
蠟	虫巛圍乂巛
耕	耒二刂
稻	禾爪臼
綺	糸大丁口
笛	竹由
捕	扌甫
喪	土口口衤
悔	心𠂉母
敦	亠口子攵
葵	艹癶一大
渴	氵日勹亡
曝	日日艹廾水
梗	木一日乂
絡	糸夂口
貫	母貝
復	行𠂉日夂
濫	氵臣𠂉一皿
況	氵口儿
陀	阝宀匕
勳	千四二火力
惑	戈口一心
簾	竹广禾禾彐
巡	之巛
徽	行山一糸攵
謹	言艹口丰
脹	月長
蓄	艹亠幺田
梓	木辛
鑑	金臣𠂉一皿
溢	氵䒑八皿
彌	弓一八巾乂乂乂乂
蓬	艹之夂丰
薦	艹鹿一乚火
硫	石亠厶川
迫	之白
貌	豸白儿
弔	丨弓
舜	爪冖夕㐄
茄	艹力口
訣	言㇕大
炭	山𠂇火
綿	糸白巾
萱	艹宀二日
岡	冂䒑山
誘	言禾㇕丿
泳	氵丶水
椅	木大丁口
遜	之子丿糸
侍	亻土寸
抑	扌匕卩
侵	亻彐冖又
妥	爪女
覽	臣𠂉一四見
概	木艮旡
貢	工貝
援	扌爪一𠂇又
昔	廿日
逮	之尹⺍
卒	亠人人十
峽	山大人人
寢	宀爿彐冖又
菱	艹土儿夂
梯	木弋弓
腕	月宀夕卩
挫	扌人人土
膝	月木人水
循	行𠂆十目
矛	予丿
努	女又力
乏	丿之
魅	鬼二木
徹	行亠厶月攵
凶	乂凵
掘	扌尸屮凵
雌	止匕隹
伽	亻力口
跡	足大八
汀	氵丁
緒	糸耂
芙	艹夫
棲	木一尹女
瑛	王艹冂大
禽	人亠乂凵冂厶
腺	月白水
迦	之力口
矯	矢丿大口冂口
欺	甘廾欠
杉	木彡
党	小冖口儿
緯	糸㐄口㐄
玖	王𠂊丶
悉	釆心
冶	冫厶口
絆	糸半
遣	之中一㠯
斐	非文
閤	門亼口
釀	酉衣口口甘
彙	彑冖田木
簿	竹氵甫寸
旬	勹日
丈	一乂
胤	儿幺月
廊	广丶艮阝
焰	火𠂊臼
壘	田田田土
淳	氵亠口子
畏	田衤
屑	尸小月
販	貝厂又
泣	氵立
沫	氵一木
滯	氵廿儿冖巾
眺	目儿⺍
寂	宀上小又
晏	日宀女
秤	禾干八
藻	艹氵口口口木
螺	虫田糸
錠	金宀一止
診	言人彡
涯	氵厂土土
滋	氵䒑幺幺
貿	卯貝
療	疒一火日小
栗	西木
朔	䒑屮月
捻	扌亼㇕心
勃	十冖子力
矩	矢匚コ
描	扌艹田
膚	虎田月
契	丰刀大
峻	山厶八夂
爵	爪四艮寸
群	尹口羊
役	行殳
痘	疒一口䒑
募	艹日大力
析	木斤
魁	鬼冫十
斥	斤丶
匡	匚王
倦	亻半卩
蔓	艹日四又
樺	木華
牟	厶牛
靴	革亻匕
慮	虎田心
眸	目厶牛
巾	巾
殊	一夕𠂉木
晟	日戊㇕
艇	舟廴丿士
芹	艹斤
寡	宀頁刀
巖	山口口厂丁耳攵
瞬	目爪冖夕㐄
邑	口巴
庸	广尹用
渾	氵冖車
紡	糸方
窺	穴夫見
奮	大隹田
濁	氵四勹虫
珂	王丁口
嗅	口自犬
寅	宀一由八
慰	尸示寸心
履	尸行𠂉日夂
宛	宀夕卩
綸	糸亼冊
獄	犭言犬
歎	艹口夫欠
蟬	虫口口甲一
督	上小又目
違	之㐄口㐄
絞	糸亠八乂
廿	廿
劣	小丿力
祈	示斤
斧	八乂斤
湛	氵甘匚儿
償	亻小冖口貝
掠	扌亠口小
崎	山大丁口
辱	辰寸
匠	匚斤
肘	月寸
究	穴九
矢	矢
葦	艹㐄口㐄
瞥	巾⺍攵目
錘	金千艹二
椰	木耳阝
梢	木小月
障	阝立日十
粟	西米
唆	口厶八夂
綜	糸宀示
詢	言勹日
札	木乚
燭	火四勹虫
襖	衤宀米大
吏	一口乂
堰	土匚日女
棺	木宀㠯
胞	月勹巳
羨	羊氵欠
阜	丿㠯十
剖	立口刂
寓	宀日冂厶
桔	木士口
轄	車宀丰口
妄	亡女
弧	弓瓜
撰	扌巳巳艹廾
哨	口小月
鋸	金尸十口
芭	艹巴
蔭	艹阝亼㇕二厶
肋	月力
煌	火白王
錐	金隹
絹	糸口月
昧	日二木
硯	石見
旨	匕日
鱗	魚米夕㐄
巳	巳
遵	之八酉寸
摺	扌习习白
拙	扌屮凵
竿	竹干
稜	禾土儿夂
憤	心十艹貝
緻	糸至攵
圭	土土
塚	土冖豕
衷	衣中
脊	⺍人月
苔	艹厶口
鉢	金木一
坂	土厂又
阪	阝厂又
恕	女口心
繭	艹冂糸丨虫
鬱	午凵木木冖乂凵匕彡
諦	言亠八冖巾
疲	疒皮
鞠	革勹米
釉	釆由
彰	立日十彡
綴	糸又又又又
酬	酉⺍川
橘	木予丿冂儿口
遁	之𠂆十目
晝	彐キ日一
窟	穴尸屮凵
鈍	金丿屮
誼	言宀且
緋	糸非
紛	糸八刀
笙	竹生
沸	氵弓刂
儉	亻亼口口人人
猿	犭土口衤
漠	氵艹日大
詐	言𠂉匕
絃	糸亠幺
俐	亻禾刂
楷	木匕匕白
侶	亻口丿口
迭	之手丶
詔	言召
嗣	口冊㇕一口
嵩	山亠口冂口
蹄	足亠八冖巾
穫	禾艹隹又
潰	氵中一貝
褐	衤日勹亡
丞	㇕水一
曜	日习习隹
鯨	魚亠口小
畜	亠幺田
宵	宀小月
戊	戊
糾	糸凵
濕	氵日幺幺火
肇	户攵彐キ
窪	穴氵土土
暇	日尸二コ又
岐	山十又
郊	亠八乂阝
璧	尸口辛王丶
糸	糸
焚	木木火
鷗	匚口口口鳥
癖	疒尸口辛
灼	火勹丶
麓	木木鹿
械	木戈廾
乞	𠂉乙
卯	卯
諧	言匕匕白
喧	口宀二日
汎	氵凡
瓢	西示瓜
裳	小冖口衣
妨	女方
綾	糸土儿夂
括	扌舌
漬	氵丰貝
戟	十日十戈
椎	木隹
檀	木亠圍口日一
葡	艹勹甫
縛	糸甫寸
垣	土二日
拘	扌勹口
篤	竹馬
鳩	九鳥
穀	士冖一禾殳
囚	圍人
鞘	革小月
瀨	氵木口刀貝
隙	阝小日小
莞	艹宀一兀
曆	厂禾禾日
伶	亻亼龴
謠	言䏑午凵
璽	一八巾乂乂乂乂王丶
拭	扌弋工
鷺	足夂口鳥
脅	力力力月
戚	戊上小
頒	八刀頁
礁	石隹火
餌	食耳
襟	衤木木示
尉	尸示寸
亥	亠凵人
肢	月十又
紐	糸彐丨
厘	厂田土
貯	貝宀丁
僕	亻业半大
憎	心八田日
禎	示卜貝
頰	大人人頁
睦	目土儿土
渦	氵咼
藩	艹氵釆田
悼	心卜日十
憾	心戊一口心
蹟	足丰貝
稚	禾隹
褒	衣亻口木
鍛	金厂三殳
町	田丁
麒	鹿甘廾
蕉	艹隹火
邸	氏一阝
柵	木冊
倭	亻禾女
笠	竹立
勉	召儿力
暑	日耂
疫	疒殳
汐	氵夕
績	心丰貝
樟	木立日十
隅	阝日冂厶
禰	示一八巾乂乂乂乂
弛	弓也
秘	禾弋八
渚	氵耂
雛	勹屮勹屮隹
樽	木八酉寸
椿	木丰日
箋	竹戈戈
寮	宀一火日小
碁	甘廾石
壬	丿士
勘	甘匚儿力
啄	口豕
駒	馬勹口
蔽	艹巾⺍攵
飼	食㇕一口
狹	犭大人人
凰	几白王
溺	氵弓冫弓冫
硝	石小月
凜	冫亠圍口禾
沓	水日
竺	竹二
圃	圍甫
誕	言廴丿止
琢	王豕
酉	酉
虜	虎田力
苛	艹丁口
茸	艹耳
諒	言亠口小
恢	心𠂇火
磯	石糸糸戈人
孜	子攵
舵	舟宀匕
璃	王亠乂凵冂厶
荻	艹犭火
漕	氵一曲日
磐	舟殳石
漱	氵木口欠
庶	广廿火
釜	八乂王八
茉	艹一木
筑	竹工凡
膳	月羊䒑口
濡	氵雨而
蕪	艹𠂉廿廿火
閑	門木
梧	木二乂口
侑	亻𠂇月
頃	匕頁
鯉	魚田土
灸	𠂊丶火
牡	牛土
飢	食几
沼	氵召
懲	行山一王攵心
逞	之口王
曖	日爪冖心夂
赦	土火攵
柚	木由
宙	宀由
柑	木甘
匿	匚艹𠂇口
馴	馬川
嘲	口十日十月
諭	言亼月刂
偵	亻卜貝
鎧	金山一口䒑
汲	氵𠂊又
輿	臼車廾
銑	金牛儿
諮	言冫欠口
炊	火欠
杵	木午
羚	羊亼龴
柿	木亠巾
頑	一兀頁
膨	月士口䒑彡
琉	王亠厶川
酌	酉勹丶
闇	門立日
嬉	女士口䒑口
殖	一夕十目
珀	王白
稼	禾宀豕
絢	糸勹日
粹	米亠人人十
鳶	弋鳥
墾	豸艮土
珈	王力口
曳	申丿
豚	月豕
犀	尸水牛
摯	土半丸手
尻	尸九
槌	木之丿㠯
芋	艹丁一
萎	艹禾女
漣	氵之車
隼	隹十
訟	言八厶
幡	巾釆田
稟	亠圍口禾
怠	厶口心
曙	日四耂
稽	禾尤匕日
巽	巳巳艹廾
綻	糸宀一止
峨	山手戈
謁	言日勹亡
愉	心亼月刂
捨	扌亼十口
懇	豸艮心
宥	宀𠂇月
骸	骨亠凵人
驍	馬土土土兀
狙	犭且
庇	广匕匕
芥	艹亻八
床	广木
楽	白⺍木
伎	亻十又
紳	糸申
詣	言匕日
慨	心艮旡
征	行一止
詰	言士口
秩	禾手丶
颯	立風
蕃	艹釆田
朽	木丂
晦	日𠂉母
扉	户非
嫉	女疒矢
幌	巾日小兀
臼	臼
傭	亻广尹用
怖	心𠂇巾
嫡	女亠八冂十口
哺	口甫
婿	女足月
挽	扌召儿
氾	氵卩
閏	門王
酪	酉夂口
渥	氵尸至
黒	田土火
饗	乚凵艮阝食
噌	口八田日
円	冂丨一
癒	疒亼月刂心
為	爲
穹	穴弓
掬	扌勹米
皿	皿
纂	竹目大糸
曇	日雨二厶
伺	亻㇕一口
榛	木丰禾
禱	示士㇕工一口寸
姥	女耂匕
顎	口口丂一頁
痢	疒禾刂
汰	氵大丶
濯	氵习习隹
煉	火木日
洵	氵勹日
気	气乂
惺	心日生
締	糸亠八冖巾
嘩	口華
僚	亻一火日小
捺	扌大示
櫓	木魚日
箕	竹甘廾
壕	土亠口冖豕
耽	耳冖儿
菅	艹宀㠯
詮	言人王
瀧	氵龍
蹴	足亠口小尤
舶	舟白
燎	火一火日小
檜	木亼四日
泌	氵弋八
宕	宀石
狩	犭宀寸
殆	一夕厶口
鷲	亠口小尤鳥
姻	女圍大
徳	行十四心
関	門䒑大
窒	穴至
翌	习习立
刈	乂刂
鍬	金禾火
舷	舟亠幺
雇	户隹
対	文寸
琥	王虎
紺	糸甘
缶	午凵
俸	亻丰キ
倖	亻土半
礎	石木木足
殉	一夕勹日
様	木羊水
収	凵又
箔	竹氵白
牲	牛生
牒	爿廿乚木
戦	⺍甲一戈
賄	貝𠂇月
鮎	魚卜口
変	大八夂
菩	艹立口
諏	言耳又
堀	土尸屮凵
憬	心日亠口小
亙	二𠂊冫
脩	亻丨攵月
徠	行木人人
繕	糸羊䒑口
岬	山甲
売	士冖儿
恣	冫欠心
児	丨日儿
竣	立厶八夂
肪	月方
涙	氵户大
賑	貝辰
釧	金川
諺	言立丿彡
庵	广大申
咲	口䒑大
柘	木石
惰	心𠂇工月
斡	十日十人冫十
銃	金亠厶儿
蕨	艹厂䒑屮欠
酵	酉耂子
沢	氵尸丶
椋	木亠口小
唾	口千艹二
惚	心勿心
蒔	艹日土寸
瀕	氵止癶頁
妊	女丿士
櫛	木竹艮卩
弁	厶廾
実	宀丰
摑	扌圍戈口一
蔑	艹四戈人
圧	厂土
砥	石氏一
迄	之𠂉乙
塾	亠口子丸土
発	癶二儿
県	目乚小
衿	衤亼㇕
昴	日卯
氷	水丶
肴	乂𠂇月
祉	示止
砦	止匕石
畿	幺幺戈田
箸	竹耂
稔	禾亼㇕心
詫	言宀丿七
歩	止小丿
処	夂几
迂	之丁一
蕎	艹丿大口冂口
佃	亻田
琶	王王巴
笈	竹𠂊又
冨	冖一口田
桜	木⺍女
陛	阝匕匕土
萄	艹勹午凵
蔦	艹鳥
唇	辰口
冗	冖几
恵	一由心
満	氵廿冂山
侮	亻𠂉母
擢	扌习习隹
菓	艹田木
賂	貝夂口
亜	亞
堺	土田人刂
伝	亻二厶
砧	石卜口
奄	大申
裾	衤尸十口
劾	亠凵人力
憧	心立田土
鎌	金禾禾彐
覚	⺍冖見
瀬	氵木口頁
碓	石隹
憩	舌自心
壊	土十四衣
嘗	小冖口匕日
譲	言衣八甘
沌	氵丿屮
縞	糸亠口冂口
喋	口廿乚木
増	土八田日
団	圍寸
広	广厶
戸	户
彗	丰丰彐
淀	氵宀一止
簞	竹口口甲一
瘍	疒日一勿
孃	女衣口口甘
髪	長彡𠂇又
毎	𠂉母十
鉄	金手丶
続	糸士冖儿
蓑	艹衣口一
酢	酉𠂉匕
彫	用口彡
偲	亻田心
毬	毛十⺍丶
兎	召儿丶
桁	木行
郞	丶艮阝
姫	女臣
値	亻十目
畑	火田
蕗	艹足夂口
梶	木尸毛
単	⺍甲一
俳	亻非
経	糸又土
験	馬亼口人
込	之人
臆	月立日心
峰	山夂丰
訃	言卜
悪	亞心
絵	糸人二厶
瑚	王十口月
錮	金圍十口
崚	山土儿夂
諄	言亠口子
竜	立申
謄	月半言
榊	木示申
図	圍冫乂
琵	王王匕匕
悌	心弋弓
赳	走凵
黙	田土犬火
嵯	山羊工
巻	半巳
鯛	魚用口
撃	車殳手
穰	禾衣口口甘
価	亻西
甥	生田力
鵜	弋弓鳥
裟	氵小丿衣
歳	止戊一小
呉	口乚廾
読	言士冖儿
両	一冂山
帰	刂彐冖巾
嶋	山鳥
総	糸八厶心
聴	耳十四心
瑠	王卯田
剣	亼口人刂
柊	木夂冫
帯	廿冖巾
穂	禾一由心
辻	之十
蔵	艹戊臣
賃	亻丿士貝
専	一由寸
転	車二厶
圏	圍半巳
豊	曲一口䒑
惇	心亠口子
萩	艹禾火
辺	之刀
脳	月⺍乂凵
応	广心
弾	弓⺍甲一
錆	金丰月
洸	氵小兀
仮	亻厂又
闘	門一口䒑寸
笹	竹廿乚
隈	阝田衤
枇	木匕匕
隠	阝爪彐心
椛	木艹亻匕
霊	雨二业
舎	人土口
藁	艹亠口冂口木
暁	日十艹兀
亀	龜
杷	木巴
篠	竹亻丨攵木
凪	几止
済	氵齊
慄	心西木
観	𠂉一隹見
稲	禾爪丨日
悩	心⺍乂凵
澪	氵雨亼龴
寛	宀艹見
険	阝亼口人
鷄	爪幺大鳥
訳	言尸丶
乗	千艹木
荘	艹爿士
雫	雨下
効	亠八乂力
疋	足
駅	馬尸丶
抜	扌𠂇又
揺	扌爪干凵
薬	艹白⺍木
醍	酉日一止
歴	厂木木止
従	行䒑止
燿	火习习隹
郷	乚凵艮阝
銭	金二戈
焼	火十艹兀
滝	氵立申
菖	艹日日
廻	廴圍口
葺	艹口耳
酔	酉九十
検	木亼口人
働	亻千日二力
斎	齊示
萠	艹月月
栖	木西
穏	禾爪彐心
檎	木人亠乂凵冂厶
踊	足龴用
槇	木匕目乚八
囲	圍二刂
懐	心亠四衣
獣	⺍田一口犬
戻	户大
薫	艹千日二火
斉	齊
営	⺍冖口丿口
栄	⺍冖木
袈	力口衣
叶	口十
喰	口食
胴	月冂一口
樋	木之龴用
晩	日召儿
軽	車又土
徴	行山王攵
紘	糸𠂇厶
頼	木口頁
毘	田匕匕
剤	齊刂
姉	女亠巾
渋	氵止氵
呪	口口儿
歓	𠂉一隹欠
嬢	女衣八甘
継	糸米乚
曽	八田日
権	木𠂉一隹
剰	千艹木刂
聡	耳八厶心
榎	木頁夂
槻	木夫見
労	⺍冖力
娩	女召儿
痩	疒申又
巣	⺍田木
丼	二刂丶
捜	扌申又
覧	臣𠂉一見
艶	曲一口䒑𠂊巴
繰	糸口口口木
錬	金木日
汚	氵丂一
埴	土十目
窓	穴厶心
騒	馬又虫
拶	扌巛夕
覇	西革月
楯	木𠂆十目
塩	土𠂉口皿
犠	牛羊手戈
駆	馬匚乂
砕	石九十
冴	冫牙
滉	氵日小兀
浄	氵𠂊尹
隣	阝米夕㐄
椀	木宀夕卩
遅	之尸羊
貰	廿乚貝
麿	广木木口丿口
蛍	⺍冖虫
縁	糸彐豕
鱒	魚八酉寸
娠	女辰
挿	扌千日
掲	扌日勹匕
扱	扌𠂊又
庁	广丁
渉	氵止小丿
仏	亻厶
歯	齒
畠	白田
脇	月力力力
厳	⺍厂丁耳攵
敍	亼木卜又
衞	行㐄口一巾
廃	广癶二儿
拝	扌一丰
酎	酉寸
袴	衤大丂一
払	扌厶
楢	木八酉
齢	齒亼龴
縄	糸黽
槙	木十目廾
惣	牛勿心
弐	戈二
駄	馬大丶
勲	千日二力火
奨	爿爪寸大
娯	女口乚廾
択	扌尸丶
壱	士冖匕
勅	木口力
栃	木𠂆一力
辿	之山
樫	木臣又土
顕	日业頁
挙	⺍廾手
讃	言夫夫貝
飜	釆田乙冫丿刂乙冫
釈	釆尸丶
栞	干干木
拠	扌夂几
匂	勹匕
拡	扌广厶
暦	厂木木日
晄	日小兀
臓	月艹戊臣
峠	山上下
陥	阝𠂊丨日
雰	雨八刀
隷	士示尹⺍
渇	氵日勹匕
潟	氵臼勹火
枠	木九十
粋	米九十
賛	夫夫貝
揃	扌䒑月刂
凧	几巾
醐	酉十口月
縦	糸行䒑止
噂	口八酉寸
皐	白⺍十
鉱	金广厶
鰯	魚弓冫弓冫
渓	氵爪夫
猟	犭⺍几キ
摂	扌耳⺍
妬	女石
疎	足木口
塁	田⺍土
顚	匕目乚八頁
粛	尹川米
塡	土匕目乚八
畳	田冖且
繊	糸十戈业
勧	𠂉一隹力
巌	山⺍厂丁耳攵
瑳	王羊工
薗	艹圍土口衤
緖	糸耂丶
塙	土亠口冂口
鞄	革勹巳
梛	木刀二阝
筈	竹舌
髄	骨之𠂇月
醸	酉衣八甘
尭	十艹兀
鋳	金丰寸
壌	土衣八甘
捗	扌止癶
喩	口亼月巛
柾	木一止
穣	禾衣八甘
愼	心匕目乚八
桟	木二戈
雑	九木隹
塀	土尸䒑廾
猫	犭艹田
澁	氵止止止
猪	犭耂
薙	艹矢隹
駈	馬丘
匁	勹乂
机	木几
倹	亻亼口人
楕	木𠂇工月
籾	米刀丶
鎭	金匕目乚八
号	口丂
逓	之𠂆二巾
祐	示𠂇口
凄	冫一尹女
遡	之䒑屮月
証	言一止
晋	一业日
亘	二日
姪	女至
痴	疒矢口
砲	石勹巳
舗	人土口甫
叙	亼木又
査	木且
倣	亻方攵
与	一乚一
国	圍王丶
却	土厶卩
担	扌日一
携	扌隹㇕丿
医	匚矢
踪	足宀示
脚	月土厶卩
胆	月日一
庄	广土
凉	冫亠口小
恒	心二日
潜	氵夫夫日
苺	艹母
芦	艹户
厩	厂艮旡
体	亻木一
怜	心亼龴
竪	臣又立
灯	火丁
粧	米广土
厨	厂一口䒑寸
凛	冫亠圍口示
奬	爿䏑寸大
叡	卜冖一八人目又
届	尸由
鶏	爪夫鳥
埼	土大丁口
眞	匕目乚八
埜	木木土
説	言八口儿
俵	亻丰衤
献	十冂半犬
菫	艹一口丰
触	𠂊用虫
櫂	木习习隹
閲	門八口儿
偽	亻爲
搾	扌穴𠂉匕
顔	立丿彡頁
浬	氵田土
絶	糸𠂊巴
卽	白匕卩
紬	糸由
殻	士冖几殳
謡	言爪干凵
緑	糸彐水
録	金彐水
没	氵殳
来	木䒑
横	木廿由八
区	匚乂
点	卜口火
旧	丨日
当	小彐
内	冂人
税	禾八口儿
会	人二厶
独	犭虫
脱	月八口儿
条	夂木
争	𠂊尹
装	爿士衣
将	爿爪寸
数	婁攵
学	⺍冖子
随	阝之𠂇月
断	米乚斤
蚕	一大虫
画	一由凵
残	一夕二戈
声	士尸
寿	丰寸
瑶	王爪干凵
静	丰月𠂊尹
挟	扌大䒑
黄	廿由八
茎	艹㇕丶工
枢	木匚乂
楼	木婁
殴	匚乂殳
虚	虎业
𠮟	口七
践	足二戈
嘱	口尸丿口冂厶
晒	日西
峡	山大䒑
乱	舌乚
称	禾竹八
辞	舌辛
俣	亻口一大
奥	宀米大
刹	乂木刂
鋭	金八口儿
狭	犭大䒑
諸	言耂丶
蛮	大八虫
状	爿犬
壮	爿士
惧	心目廾
悦	心八口儿
惨	心厶大彡
誉	⺍廾言
滞	氵艹丨冖巾
浅	氵二戈
湿	氵日业
温	氵日皿
写	冖一乚一
祷	示丰寸
宝	宀王丶
窃	穴七刀
遥	之爪干凵
礼	示乚
禅	示⺍甲一
属	尸丿口冂厶
昼	尸丶日一
尽	尸丶冫
弥	弓竹八
参	厶大彡
福	示一口田
神	示申
祥	示羊
都	耂丶阝
麺	丰夂頁圍
麦	丰夂
桧	木人二厶
励	厂一力力
欧	匚乂欠
戯	虎业戈
径	行㇕丶工
猪	犭耂丶
恋	大八心
産	立丿生
彦	立丿彡
盗	冫欠皿
炉	火户
湾	氵大八弓
寝	宀爿彐冖又
祢	示竹八
禄	示彐水
双	又又
堕	阝𠂇月土
