的	白勹丶
了	了
我	手戈
是	日一止
在	一亻土
你	亻竹八
和	禾口
有	𠂇月
不	不
就	亠口小尤
都	耂阝
也	也
要	西女
吧	口巴
好	女子
他	亻也
去	土厶
到	至刂
上	上
那	刀二阝
人	人
看	手目
中	中
呢	口尸匕
她	女也
等	竹土寸
用	用
把	扌巴
下	下
恩	圍大心
能	厶月匕匕
很	行艮
多	夕夕
做	亻十口攵
想	木目心
被	衤皮
地	土也
而	而
一	一
又	又
再	一冂土
但	亻日一
打	扌丁
大	大
年	𠂉㐄
啦	口扌立
以	厶人
嗯	口圍大心
着	羊目
小	小
得	行日一寸
先	牛儿
啊	口阝丁口
或	戈口一
呀	口牙
找	扌戈
新	立木斤
及	𠂊又
跟	足艮
太	大丶
嘛	口广木木
日	日
才	十丿
可	丁口
比	匕匕
玩	王一兀
最	日耳又
月	月
真	十目廾
吃	口𠂉乙
它	宀匕
其	甘廾
叫	口凵
出	屮凵
哈	口亼口
向	宀口
家	宀豕
之	之
更	一日乂
走	走
快	心㇕大
前	䒑月刂
由	由
高	亠口冂口
您	亻竹八心
加	力口
所	户斤
天	一大
已	巳
里	田土
啥	口亼十口
老	耂匕
搞	扌亠口冂口
行	行
事	一中彐
拿	亼口手
如	女口
死	一夕匕
像	亻召豕
使	亻一口乂
成	戊㇕
只	口八
哪	口刀二阝
回	圍口
少	小丿
元	一兀
卡	上卜
靠	牛口非
算	竹目廾
者	耂
忙	心亡
起	走巳
各	夂口
分	八刀
咯	口夂口
水	水
改	巳攵
唉	口厶矢
三	三
放	方攵
全	人王
按	扌宀女
早	日十
拉	扌立
弄	王廾
本	木一
偶	亻日冂厶
性	心生
第	竹弋弓
完	宀一兀
同	冂一口
花	艹亻匕
怕	心白
女	女
些	止匕二
住	亻丶王
名	夕口
跑	足勹巳
次	冫欠
睡	目千艹二
哦	口手戈
挺	扌廴亻土
王	王
掉	扌卜日十
路	足夂口
正	一止
外	夕卜
二	二
生	生
心	心
因	圍大
子	子
作	亻𠂉匕
送	之䒑大
每	𠂉母
法	氵土厶
乖	千北
拍	扌白
市	亠巾
撒	扌廿月攵
至	至
接	扌立女
美	羊大
表	丰衤
未	二木
非	非
即	艮卩
哎	口艹乂
此	止匕
差	羊工
版	爿𠂆又
副	一口田刂
系	丿糸
收	凵攵
男	田力
俺	亻大申
字	宀子
股	月殳
便	亻一日乂
考	耂丂
手	手
道	之八頁
米	米
座	广人人土
聊	耳卯
取	耳又
低	亻氏丶
哇	口土土
受	爪冖又
包	勹巳
阿	阝丁口
喝	口日勹亡
白	白
金	金
四	四
近	之斤
管	竹宀㠯
定	宀一止
交	亠八乂
李	木子
笑	竹丿大
自	自
型	一廾刂土
黑	四土火
慢	心日四又
刷	尸巾刂
穿	穴牙
越	走戈乚
位	亻立
部	立口阝
站	立卜口
牛	牛
怪	心又土
省	小丿目
倒	亻至刂
曾	八四日
累	田糸
汗	氵干
查	木日一
象	召豕
半	半
格	木夂口
五	二乂
方	方
某	甘木
唔	口二乂口
海	氵𠂉母
相	木目
光	小兀
咋	口𠂉匕
且	且
林	木木
化	亻匕
班	王刂王
滴	氵亠八冂十口
店	广卜口
安	宀女
坐	人人土
度	广廿又
俄	亻手戈
歌	丁口丁口欠
信	亻言
若	艹𠂇口
原	厂白小
文	文
晚	日召儿
量	日一田土
村	木寸
式	弋工
空	穴工
山	山
毛	毛
重	千日土
主	丶王
另	口力
入	人
伐	亻戈
血	丿皿
爽	大乂乂乂乂
往	行丶王
片	爿
狗	犭勹口
共	艹廾
西	西
周	用口
超	走召
明	日月
均	土勹冫
期	甘廾月
照	日召火
切	七刀
留	卯田
特	牛土寸
神	示申
教	耂子攵
哥	丁口丁口
甘	甘
值	亻十目
么	丿厶
陪	阝立口
既	艮旡
哭	口口犬
力	力
建	廴彐キ
洗	氵牛儿
懂	心艹千日土
口	口
指	扌匕日
球	王十⺍丶
仍	亻㇕丿
活	氵舌
跌	足手丶
清	氵丰月
提	扌日一止
除	阝亼木
通	之龴用
酒	氵酉
票	西示
六	亠八
病	疒一冂人
咩	口羊
假	亻尸二コ又
久	𠂊丶
段	厂三殳
平	干八
抓	扌爪
套	大長
急	𠂊彐心
城	土戊㇕
任	亻丿士
草	艹日十
理	王田土
令	亼龴
雨	雨
唱	口日日
左	𠂇工
常	小冖口巾
色	𠂊巴
菜	艹爪木
集	隹木
感	戊一口心
房	户方
混	氵日匕匕
敢	㇕耳攵
火	火
操	扌口口口木
南	十冂半
退	之艮
件	亻牛
破	石皮
德	行十四一心
雪	雨彐
局	尸㇕口
噢	口宀米大
整	木口攵一止
傻	亻囟八夂
克	十口儿
呃	口厂卩
喊	口戊一口
跳	足儿⺍
沈	氵冖儿
反	𠂆又
篇	竹户冊
待	行土寸
砸	石匚巾
深	氵冖八木
根	木艮
求	十⺍丶
投	扌殳
款	士示欠
知	矢口
八	八
配	酉巳
器	口口犬口口
何	亻丁口
率	亠幺⺍十
鬼	鬼
修	亻丨夂彡
面	頁圍
北	北
木	木
份	亻八刀
情	心丰月
肉	䏑
需	雨而
七	七
流	氵亠厶川
噶	口艹日勹亡
招	扌召
痛	疒龴用
列	一夕刂
石	石
香	禾日
封	土土寸
眼	目艮
易	日勿
冷	冫亼龴
借	亻廿日
派	氵𠂆亻
付	亻寸
十	十
油	氵由
胡	十口月
排	扌非
停	亻亠口冖丁
合	亼口
身	身
章	立日十
科	禾冫十
星	日生
牌	爿鬼十
翻	釆田习习
帖	巾卜口
商	亠八冂八口
物	牛勿
泡	氵勹巳
玉	王丶
追	之丿㠯
背	北月
解	𠂊用刀牛
室	宀至
底	广氏丶
代	亻弋
朱	𠂉木
亦	大八
乾	十日十𠂉乙
工	工
咱	口自
刀	刀
喔	口尸至
波	氵皮
推	扌隹
落	艹氵夂口
春	丰日
笨	竹木一
九	九
江	氵工
短	矢一口䒑
含	亼㇕口
千	千
炒	火小丿
藉	艹耒廿日
丫	八丨
徐	行亼木
秒	禾小丿
青	丰月
耍	而女
夜	亠亻夂丶
吹	口欠
板	木𠂆又
土	土
姐	女且
直	十目
公	八厶
苦	艹十口
秀	禾㇕丿
博	十甫寸
皮	皮
朝	十日十月
君	尹口
利	禾刂
素	丰糸
立	立
存	一亻子
吾	二乂口
民	巳七
命	亼口卩
睇	目弋弓
忘	亡心
茶	艹人木
冰	冫水
供	亻艹廾
案	宀女木
田	田
初	衤刀
品	口口口
抽	扌由
造	之牛口
抱	扌勹巳
野	田土予
胖	月半
故	十口攵
服	月卩又
百	一白
兵	斤廾
英	艹冂大
般	舟殳
演	氵宀一由八
嘴	口止匕𠂊用
填	土十目廾
果	田木
保	亻口木
唐	广尹口
夏	頁夂
莫	艹日大
硬	石一日乂
寒	宀甘八冫
挖	扌穴乙
凡	凡
言	言
防	阝方
街	行土土
距	足匚コ
挑	扌儿⺍
欲	八人口欠
竟	立日儿
源	氵厂白小
官	宀㠯
寄	宀大丁口
古	十口
首	八頁
思	田心
郭	亠口子阝
亮	亠口冖几
干	干
粉	米八刀
爆	火日艹廾水
戴	十戈田艹廾
然	䏑犬火
疼	疒夂冫
雷	雨田
港	氵艹廾巳
租	禾且
狼	犭丶艮
狂	犭王
布	𠂇巾
引	弓丨
捏	扌日土
佛	亻弓刂
食	食
船	舟几口
今	亼㇕
恨	心艮
宋	宀木
猛	犭子皿
客	宀夂口
友	𠂇又
句	勹口
斯	甘廾斤
沙	氵小丿
哼	口亠口了
望	亡月王
腿	月之艮
丁	丁
祝	示口儿
界	田人刂
抗	扌亠几
步	止癶
河	氵丁口
缺	午凵㇕大
尚	小冂口
似	亻厶人
羊	羊
福	示一口田
必	弋八
遭	之一曲日
否	不口
端	立山而
猜	犭丰月
伊	亻尹
秦	丰禾
秋	禾火
毒	丰母
架	力口木
熊	厶月匕匕火
持	扌土寸
插	扌千臼
折	扌斤
意	立日心
呆	口木
基	甘廾土
困	圍木
圈	圍半卩
迷	之米
踢	足日勿
史	口乂
甲	甲
呵	口丁口
搬	扌舟殳
乃	㇕丿
右	𠂇口
塔	土艹亼口
拖	扌𠂉也
摸	扌艹日大
院	阝宀一兀
散	廿月攵
松	木人厶
爸	八乂巴
喜	士口䒑口
洋	氵羊
呈	口王
治	氵厶口
降	阝夂㐄
富	宀一口田
姓	女生
料	米冫十
嘎	口頁戈
咬	口亠八乂
梅	木𠂉母
批	扌匕匕
足	足
爬	爪巴
醒	酉日生
狠	犭艮
逛	之犭王
精	米丰月
瘦	疒臼丨又
踩	足爪木
偷	亻亼月刂
支	十又
杜	木土
鞋	革土土
展	尸廿衤
咧	口一夕刂
依	亻衣
倍	亻立口
康	广尹⺍
堂	小冖口土
救	十⺍丶攵
音	立日
世	廿乚
著	艹耂
仲	亻中
舞	𠂉廿廿夕㐄
守	宀寸
露	雨足夂口
冒	冖二目
弱	弓冫弓冫
影	日亠口小彡
州	⺍川
替	夫夫日
逼	之一口田
曲	曲
牙	牙
箱	竹木目
遍	之户冊
巴	巴
武	戈止
湖	氵十口月
程	禾口王
柳	木卯
偏	亻户冊
印	臼卩
味	口二木
零	雨亼龴
角	𠂊用
紫	止匕糸
勒	革力
耶	耳阝
熟	亠口子丸火
孔	子乚
寸	寸
厚	厂日子
答	竹亼口
社	示土
兼	禾禾彐
娘	女丶艮
登	癶一口䒑
微	行山一几攵
佳	亻土土
瞭	目一火日小
雅	牙隹
魔	广木木鬼
司	㇕一口
志	士心
奇	大丁口
瓦	瓦
居	尸十口
盛	戊㇕皿
奶	女㇕丿
虎	虎
后	𠂆一口
洞	氵冂一口
台	厶口
形	一廾彡
川	川
充	亠厶儿
害	宀丰口
喂	口田衤
免	召儿
景	日亠口小
曹	一曲日
煮	耂火
良	丶艮
蛋	足虫
吐	口土
肥	月巴
仙	亻山
碰	石立立
酸	酉厶八夂
侯	亻コ矢
塞	宀甘八土
欠	欠
擦	扌宀䏑又示
藏	艹戈爿臣
皆	匕匕白
屁	尸匕匕
永	丶水
夫	夫
琴	王王亼㇕
宏	宀𠂇厶
例	亻一夕刂
砍	石欠
兄	口儿
善	羊䒑口
增	土八四日
施	方𠂉也
暗	日立日
忍	刀丶心
肯	止月
母	母
艾	艹乂
致	至攵
宗	宀示
麻	广木木
怒	女又心
扔	扌㇕丿
游	氵方𠂉子
腰	月西女
嫩	女木口攵
肖	小月
罪	四非
仔	亻子
丑	彐丨
敏	𠂉母攵
棒	木丰キ
臭	自犬
拆	扌斤丶
蔡	艹䏑又示
校	木亠八乂
氏	氏
糖	米广尹口
吉	士口
押	扌甲
吵	口小丿
谷	八人口
衣	衣
宇	宀丁一
末	一木
潘	氵釆田
告	牛口
旁	亠八冖方
耐	而寸
董	艹千日土
榜	木亠八冖方
醉	酉亠人人十
妹	女二木
宜	宀且
尼	尸匕
灰	𠂇火
屋	尸至
楚	木木足
丹	冊丶
乘	禾北
刻	亠凵人刂
俊	亻厶八夂
芳	艹方
抄	扌小丿
酷	酉牛口
京	亠口小
返	之𠂆又
瑞	王山而
仁	亻二
添	氵一大心
催	亻山隹
具	目廾
威	戊一女
核	木亠凵人
瓶	䒑廾瓦
犯	犭卩
族	方𠂉矢
季	禾子
骨	骨
嘿	口四土火
黎	禾丿刀人水
密	宀弋八山
士	士
炸	火𠂉匕
祇	示氏
洪	氵艹廾
容	穴人口
射	身寸
智	矢口日
索	十冖糸
聚	耳又亻
拼	扌䒑廾
燕	廿口北火
撞	扌立田土
膜	月艹日大
普	立立日
竹	竹竹
魏	禾女鬼
乜	㇕乚
范	艹氵卩
搭	扌艹亼口
袁	土口衤
扯	扌止
彭	士口䒑彡
薄	艹氵甫寸
曰	日
胃	田月
堆	土隹
赴	走卜
躲	身几木
孟	子皿
抵	扌氏丶
甜	舌甘
彩	爪木彡
甚	甘匚八
厄	厂卩
粗	米且
申	申
念	亼㇕心
惹	艹𠂇口心
盒	亼口皿
逃	之儿⺍
嘉	士口䒑力口
升	丿廾
姚	女儿⺍
休	亻木
症	疒一止
斤	斤
功	工力
喇	口木口刂
浪	氵丶艮
扣	扌口
泰	丰水
忠	中心
梁	氵刀八木
吸	口𠂊又
跨	足大一丂
森	木木木
瞎	目宀丰口
卷	半卩
于	丁一
井	二刂
蛇	虫宀匕
寺	土寸
屏	尸䒑廾
灌	氵艹口口隹
埋	土田土
略	田夂口
目	目
蒙	艹冖一豕
托	扌丿七
巧	工丂
淡	氵火火
拜	手一丰
冬	夂冫
娜	女刀二阝
池	氵也
敲	亠口冂口卜又
愁	禾火心
勇	龴用力
泥	氵尸匕
昏	氏日
遇	之日冂厶
巨	匚コ
怎	𠂉匕心
磨	广木木石
呼	口爪丁
液	氵亠亻夂丶
泉	白水
嫁	女宀豕
汪	氵王
稍	禾小月
薛	艹丿㠯辛
豆	一口䒑
旺	日王
攻	工攵
祥	示羊
委	禾女
佐	亻𠂇工
隔	阝一口冂八丁
崔	山隹
碗	石宀夕卩
吻	口勿
健	亻廴彐キ
速	之木口
失	手丶
雄	𠂇厶隹
胸	月勹乂凵
框	木匚王
暴	日艹廾水
娃	女土土
唯	口隹
漏	氵尸雨
拔	扌犬㇕
洛	氵夂口
探	扌冖八木
碟	石廿乚木
郎	丶艮阝
珠	王𠂉木
尿	尸水
透	之禾㇕丿
惠	一日厶心
府	广亻寸
菲	艹非
叼	口㇕一
父	八乂
耳	耳
窗	穴囟夂
搜	扌臼丨又
希	乂𠂇巾
患	中中心
尾	尸毛
播	扌釆田
岩	山石
逗	之一口䒑
限	阝艮
帝	亠八冖巾
昌	日日
模	木艹日大
扁	户冊
舒	亼十口予
嫌	女禾禾彐
陶	阝勹午凵
苗	艹田
剪	䒑月刂刀
羽	习习
哩	口田土
稿	禾亠口冂口
邦	丰阝
玲	王亼龴
坑	土亠几
袋	亻弋衣
趁	走人彡
妖	女丿大
甩	月乚
琳	王木木
乙	乙
伴	亻半
尊	八酉寸
熬	丰力攵火
吊	口巾
霜	雨木目
沿	氵几口
伯	亻白
浩	氵牛口
剩	禾北刂
域	土戈口一
祖	示且
肺	月一巾
附	阝亻寸
制	牛巾刂
玄	亠幺
置	四十目
豪	亠口冖豕
助	且力
幽	幺幺山
欣	斤欠
辣	辛木口
煤	火甘木
瓜	瓜
俾	亻鬼十
慧	丰丰彐心
墨	四土火土
娶	耳又女
犬	犬
炎	火火
震	雨辰
遂	之八豕
斌	文戈止
控	扌穴工
覆	西行𠂉日夂
趟	走小冂口
禁	木木示
烤	火耂丂
童	立田土
徵	行山一王攵
杯	木不
暨	艮旡日一
晴	日丰月
魂	二厶鬼
益	䒑八皿
庭	广廴亻土
肝	月干
坊	土方
晨	日辰
振	扌辰
割	宀丰口刂
消	氵小月
兆	儿⺍
隆	阝夂一生
撤	扌亠厶月攵
粥	弓米弓
馨	士尸殳禾日
滑	氵骨
曼	日四又
暖	日爪一𠂇又
己	巳
止	止
柱	木丶王
妻	一尹女
盾	𠂆十目
奔	大十艹
政	一止攵
爹	八乂夕夕
尹	尹
廖	广习习人彡
刺	木冂刂
冠	冖一兀寸
躺	身小冂口
舍	亼十口
鑫	金金金
售	隹口
婚	女氏日
妞	女彐丨
邱	丘阝
兔	召儿丶
敬	艹勹口攵
潮	氵十日十月
昂	日匕卩
咳	口亠凵人
邪	牙阝
促	亻足
鼠	臼釆
葛	艹日勹亡
串	中中
桑	又又又木
苑	艹夕卩
迎	之匕卩
弓	弓
碎	石亠人人十
余	亼木
承	㇕水三
迪	之由
臣	臣
勤	廿口丰力
摔	扌亠幺⺍十
蒸	艹㇕水一火
凌	冫土八夂
辛	辛
旗	方𠂉甘廾
妙	女小丿
始	女厶口
符	竹亻寸
亭	亠口冖丁
吼	口子乚
云	二厶
研	石一廾
咪	口米
俗	亻八人口
珍	王人彡
卓	卜日十
嗨	口氵𠂉母
捧	扌丰キ
舔	舌一大心
喃	口十冂半
愈	亼月刂心
溪	氵爪幺大
歪	不一止
晃	日小兀
斜	亼木冫十
尤	尤
洲	氵⺍川
乎	爪丁
湘	氵木目
翔	羊习习
枝	木十又
逸	之召儿丶
哄	口艹廾
餐	卜夕又食
染	氵九木
粘	米卜口
炮	火勹巳
桌	卜日木
芬	艹八刀
萍	艹氵干八
晶	日日日
勾	勹厶
戒	戈廾
桂	木土土
朗	丶艮月
堵	土耂
矣	厶矢
捐	扌口月
荷	艹亻丁口
棉	木白巾
私	禾厶
姜	羊女
嗲	口八乂夕夕
鼓	士口䒑十又
霞	雨尸二コ又
瞧	目隹火
皇	白王
企	人止
互	一彑
沉	氵冖几
箭	竹䒑月刂
柏	木白
焦	隹火
憋	巾⺍攵心
盟	日月皿
延	廴丿止
柔	予丿木
粒	米立
盆	八刀皿
眉	尸目
碧	王白石
籍	竹耒廿日
刮	舌刂
勿	勿
坤	土申
汁	氵十
浴	氵八人口
翼	习习田艹廾
哲	扌斤口
涵	氵了⺍凵
菌	艹圍禾
桶	木龴用
抹	扌一木
判	半刂
弟	弋弓
傅	亻甫寸
衰	衣口一
柯	木丁口
叔	上小又
肩	户月
殿	尸艹廾殳
番	釆田
怡	心厶口
旭	九日
航	舟亠几
妮	女尸匕
坡	土皮
旅	方𠂉亻
赤	土火
技	扌十又
摘	扌亠八冂十口
翠	习习亠人人十
孝	耂子
移	禾夕夕
予	予
岳	丘山
屎	尸米
融	一口冂八丁虫
棋	木甘廾
扶	扌夫
介	亻八
渡	氵广廿又
芯	艹心
采	爪木
乳	爪子乚
拳	半手
浜	氵斤廾
薇	艹行山一几攵
淫	氵爪丿士
拽	扌申丿
宅	宀丿七
掌	小冖口手
培	土立口
莉	艹禾刂
盼	目八刀
握	扌尸至
截	十戈隹
酶	酉𠂉母
孤	子瓜
邵	召阝
什	亻十
宣	宀二日
妍	女一廾
尖	小大
醋	酉廿日
朵	几木
穆	禾白小彡
姬	女臣
啃	口止月
耗	耒毛
息	自心
伍	亻二乂
塘	土广尹口
逢	之夂丰
桃	木儿⺍
壁	尸口辛土
霍	雨隹
漆	氵木人水
虹	虫工
丸	丸
券	半刀
俱	亻目廾
菊	艹勹米
奴	女又
岸	山厂干
凝	冫匕矢龴足
芝	艹之
兮	八丂
烈	一夕刂火
矮	矢禾女
婆	氵皮女
俞	亼月刂
蝶	虫廿乚木
枕	木冖儿
避	之尸口辛
郝	土火阝
帕	巾白
浮	氵爪子
盈	㇕丿又皿
枚	木攵
材	木十丿
扎	扌乚
翁	八厶习习
幻	幺㇕
衫	衤彡
杆	木干
固	圍十口
耀	小兀习习隹
槽	木一曲日
穴	穴
幅	巾一口田
伸	亻申
悲	非心
殷	𠂆彐㇕殳
萌	艹日月
斑	王文王
澡	氵口口口木
屈	尸屮凵
娟	女口月
怨	夕卩心
恐	工凡心
柴	止匕木
逆	之䒑屮
渣	氵木日一
熙	臣巳火
抖	扌冫十
忽	勿心
津	氵彐キ
胎	月厶口
准	冫隹
摩	广木木手
漫	氵日四又
溜	氵卯田
扇	户习习
婷	女亠口冖丁
堡	亻口木土
淘	氵勹午凵
墓	艹日大土
鹿	鹿
彬	木木彡
蹭	足八四日
卿	丿凵艮卩
琪	王甘廾
函	了⺍凵
郡	尹口阝
奈	大示
茂	艹戊
肌	月几
薰	艹千四二火
映	日冂大
鼻	自田廾
泵	石水
育	亠厶月
澳	氵宀米大
候	亻丨コ矢
种	禾中
邀	之白方攵
噻	口宀甘八土
佩	亻几一巾
策	竹木冂
藤	艹月半水
仿	亻方
磊	石石石
雁	厂亻隹
窄	穴𠂉匕
昨	日𠂉匕
倪	亻臼儿
雯	雨文
戈	戈
爪	爪
癌	疒口口口山
效	亠八乂攵
拷	扌耂丂
猴	犭亻コ矢
掏	扌勹午凵
汝	氵女
撮	扌日耳又
幸	土半
揉	扌予丿木
舟	舟
盯	目丁
蜜	宀弋八虫
漂	氵西示
序	广予
巷	艹廾巳
梨	禾刂木
舌	舌
蒂	艹亠八冖巾
腹	月𠂉日夂
蟹	𠂊用刀牛虫
陷	阝𠂊臼
捉	扌足
疑	匕矢龴足
鼎	目爿爿
慌	心艹亡川
瘤	疒卯田
彼	行皮
辰	辰
忌	巳心
踏	足水日
捷	扌一彐止
罐	午凵艹口口隹
伏	亻犬
默	四土火犬
赫	土火土火
杰	木火
孩	子亠凵人
咖	口力口
悟	心二乂口
帽	巾冖二目
幼	幺力
旋	方𠂉足
壹	士冖一口䒑
霸	雨革月
席	广廿巾
叉	又丶
妃	女巳
典	冊廾
儒	亻雨而
裸	衤田木
奉	丰キ
叻	口力
御	行午止卩
腔	月穴工
突	穴犬
刑	一廾刂
痕	疒艮
午	午
蕾	艹雨田
宰	宀辛
囊	一中冖口口甘衤
弘	弓厶
境	土立日儿
拒	扌匚コ
毅	立豕殳
煎	䒑月刂火
弦	弓亠幺
渝	氵亼月刂
罩	四卜日十
蓉	艹穴人口
卵	卯丶丶
尺	尸丶
逾	之亼月刂
垂	千艹二
惜	心廿日
浦	氵甫
警	艹勹口攵言
扛	扌工
氧	气羊
揭	扌日勹亡
逐	之豕
昭	日召
宿	宀亻一白
裂	一夕刂衣
僧	亻八四日
裙	衤尹口
彪	虎彡
淋	氵木木
束	木口
牢	宀牛
揍	扌丰一大
仕	亻士
劫	土厶力
拓	扌石
扮	扌八刀
喻	口亼月刂
律	行彐キ
株	木𠂉木
砂	石小丿
埃	土厶矢
斗	冫十
坪	土干八
仇	亻九
吞	一大口
亡	亡
沾	氵卜口
牧	牛攵
霖	雨木木
兜	白卯儿
寨	宀甘八木
掐	扌𠂊臼
稀	禾乂𠂇巾
恰	心亼口
棍	木日匕匕
啵	口氵皮
朕	月䒑大
淑	氵上小又
慕	艹日大心
歇	日勹亡欠
疏	足亠厶川
膏	亠口冖口月
陵	阝土八夂
姆	女母
碳	石山𠂇火
廷	廴亻土
糊	米十口月
楠	木十冂半
蚊	虫文
祭	䏑又示
嘞	口革力
拾	扌亼口
裴	非衣
朋	月月
媚	女尸目
芸	艹二厶
吟	口亼㇕
筒	竹冂一口
丘	丘
趴	足八
繁	𠂉母攵糸
坦	土日一
穗	禾一日厶心
屯	一屮
虐	虎匚一
蹲	足八酉寸
惟	心隹
幕	艹日大巾
扒	扌八
搓	扌羊工
遮	之广廿火
庚	广彐人
哉	十戈口
涉	氵止癶
忒	弋心
臂	尸口辛月
敷	甫方攵
佬	亻耂匕
阮	阝一兀
丙	一冂人
署	四耂
示	示
邢	一廾阝
莎	艹氵小丿
夕	夕
苯	艹木一
趣	走耳又
渠	氵匚コ木
杭	木亠几
疾	疒矢
崇	山宀示
涅	氵日土
裕	衤八人口
挪	扌刀二阝
荒	艹亡川
筋	竹月力
孕	㇕丿子
撕	扌甘廾斤
戳	习习隹戈
帆	巾凡
奎	大土土
阻	阝且
享	亠口子
棚	木月月
傲	亻丰力攵
蹦	足山月月
焊	火日干
召	召
徒	行走
脂	月匕日
几	几
艘	舟臼丨又
喵	口艹田
靖	立丰月
奏	丰一大
咒	口口几
盲	亡目
姿	冫欠女
炫	火亠幺
坎	土欠
琦	王大丁口
拌	扌半
樊	木乂乂木大
缸	午凵工
弗	弓刂
狐	犭瓜
栽	十戈木
硅	石土土
述	之木丶
泛	氵丿之
甫	甫
佑	亻𠂇口
卦	土土卜
耿	耳火
咽	口圍大
倩	亻丰月
袖	衤由
糟	米一曲日
激	氵白方攵
珊	王冊
潭	氵西日十
蠢	丰日虫虫
植	木十目
占	卜口
倚	亻大丁口
姨	女大弓
幢	巾立田土
焉	一止一乚火
茹	艹女口
桐	木冂一口
痰	疒火火
捂	扌二乂口
万	一力
蒲	艹氵甫
芽	艹牙
昊	日一大
碑	石鬼十
嚼	口爪四艮寸
燃	火䏑犬火
朴	木卜
煲	亻口木火
杖	木一乂
磷	石米夕㐄
脆	月𠂊厂卩
刃	刀丶
姑	女十口
衡	行𠂊田大
措	扌廿日
眠	目巳七
途	之亼木
鄂	口口一丂阝
捅	扌龴用
禾	禾
磁	石䒑幺幺
沃	氵丿大
肚	月土
哀	衣口
浸	氵彐冖又
柄	木一冂人
跪	足𠂊厂卩
瓷	冫欠瓦
踹	足山而
凸	圍冂
瑜	王亼月刂
磅	石亠八冖方
宴	宀日女
堪	土甘匚八
麟	鹿米夕㐄
翟	习习隹
仗	亻一乂
崩	山月月
革	革
莪	艹手戈
聘	耳由丂
刊	干刂
裁	十戈衣
郁	𠂇月阝
逝	之扌斤
狄	犭火
塌	土日习习
崖	山厂土土
廉	广禾禾彐
婉	女宀夕卩
攀	木乂乂木大手
喘	口山而
氮	气火火
鞍	革宀女
巫	工人人
虞	虎口一大
沁	氵心
瑟	王王弋八
揪	扌禾火
棵	木田木
拐	扌口力
披	扌皮
削	小月刂
悠	亻丨攵心
睿	卜冖一八人目
凹	圍凵
葬	艹一夕匕廾
咦	口大弓
瞪	目癶一口䒑
詹	𠂊厂八言
侃	亻口川
授	扌爪冖又
卸	午止卩
慈	䒑幺幺心
瞄	目艹田
鞭	革亻一日乂
危	𠂊厂卩
泊	氵白
喉	口亻コ矢
溶	氵穴人口
媛	女爪一𠂇又
拎	扌亼龴
察	宀䏑又示
昆	日匕匕
禹	丿口冂厶
娥	女手戈
醇	酉亠口子
橙	木癶一口䒑
辨	辛刂辛
暮	艹日大日
薪	艹立木斤
巢	巛田木
脾	月鬼十
愚	日冂厶心
蜀	四勹虫
裹	衣田木
藕	艹耒日冂厶
滕	月半水
劈	尸口辛刀
堤	土日一止
拱	扌艹廾
夸	大一丂
傍	亻亠八冖方
燥	火口口口木
茜	艹西
允	厶儿
杏	木口
芒	艹亡
畔	田半
豹	豸勹丶
澄	氵癶一口䒑
冥	冖日亠八
媒	女甘木
酥	酉禾
垮	土大一丂
枯	木十口
塑	䒑屮月土
卜	卜
茅	艹予丿
搏	扌甫寸
沐	氵木
豫	予召豕
蒜	艹示示
雀	小隹
亨	亠口了
腐	广亻寸䏑
皓	白牛口
央	冂大
氟	气弓刂
冤	冖召儿丶
据	扌尸十口
浙	氵扌斤
栓	木人王
梳	木亠厶川
冀	北田艹廾
筱	竹亻丨攵
冉	冂土
彤	冊丶彡
奕	大八大
卑	鬼十
誓	扌斤言
蜂	虫夂丰
勺	勹丶
迅	之乙十
虫	虫
匹	匚儿
曦	日羊禾戈丂
仰	亻匕卩
煞	𠂊彐攵火
羞	羊彐丨
注	氵丶王
嫂	女臼丨又
瞳	目立田土
黛	亻弋四土火
妾	立女
拂	扌弓刂
挨	扌厶矢
泄	氵廿乚
茨	艹冫欠
夷	大弓
慎	心十目廾
汽	氵气
婕	女一彐止
恭	艹廾心
弊	巾⺍攵廾
旦	日一
涂	氵亼木
氯	气彐水
祁	示阝
乍	𠂉匕
孰	亠口子丸
耕	耒二刂
稻	禾爪臼
屠	尸耂
笛	竹由
捕	扌甫
蕊	艹心心心
氨	气宀女
愣	心四方
幺	幺
悔	心𠂉母
敦	亠口子攵
葵	艹癶一大
磕	石土厶皿
渴	氵日勹亡
曝	日日艹廾水
撇	扌巾⺍攵
梗	木一日乂
蔚	艹尸示寸
翅	十又习习
估	亻十口
瓣	辛瓜辛
淮	氵隹
陀	阝宀匕
惑	戈口一心
巡	之巛
墩	土亠口子攵
徽	行山一糸攵
蓄	艹亠幺田
梓	木辛
匪	匚非
昕	日斤
溢	氵䒑八皿
寇	宀一兀卜又
佟	亻夂冫
蓬	艹之夂丰
硫	石亠厶川
俏	亻小月
迫	之白
貌	豸白儿
舜	爪冖夕㐄
炳	火一冂人
茄	艹力口
炭	山𠂇火
萱	艹宀二日
挂	扌土土
掀	扌斤欠
翰	十日十人习习
掩	扌大申
蹬	足癶一口䒑
泳	氵丶水
玫	王攵
椅	木大丁口
甄	西土瓦
侍	亻土寸
抑	扌匕卩
敖	丰力攵
酮	酉冂一口
毫	亠口冖毛
侵	亻彐冖又
妥	爪女
概	木艮旡
呦	口幺力
援	扌爪一𠂇又
昔	廿日
晾	日亠口小
逮	之尹⺍
卒	亠人人十
捆	扌圍木
彷	行方
菱	艹土八夂
梯	木弋弓
籽	米子
腕	月宀夕卩
挫	扌人人土
膝	月木人水
嗦	口十冖糸
璇	王方𠂉足
眨	目丿之
循	行𠂆十目
臀	尸艹廾殳月
矛	予丿
努	女又力
黔	四土火亼㇕
乏	丿之
魅	鬼二木
凶	乂凵
胺	月宀女
掘	扌尸屮凵
茗	艹夕口
璐	王足夂口
雌	止匕隹
旱	日干
掰	手八刀手
伽	亻力口
蛙	虫土土
雕	用口隹
痣	疒士心
汀	氵丁
隋	阝𠂇工月
祛	示土厶
芙	艹夫
刁	㇕一
瑛	王艹冂大
禽	人亠乂凵冂厶
腺	月白水
迦	之力口
欺	甘廾欠
杉	木彡
党	小冖口儿
玖	王𠂊丶
肆	長彐キ
悉	釆心
掂	扌广卜口
菁	艹丰月
冶	冫厶口
遣	之中一㠯
岑	山亼㇕
皖	白宀一兀
糕	米羊火
斐	非文
址	土止
蘸	艹酉隹火
茵	艹圍大
簿	竹氵甫寸
旬	勹日
丈	一乂
咸	戊一口
呸	口不一
胤	儿幺月
桓	木二日
碘	石冊廾
瞅	目禾火
廊	广丶艮阝
焰	火𠂊臼
淳	氵亠口子
畏	田衤
屑	尸小月
酯	酉匕日
覃	西日十
嵌	山甘欠
泣	氵立
袍	衤勹巳
僵	亻三田田
沫	氵一木
臻	至丰禾
眺	目儿⺍
寂	宀上小又
晏	日宀女
秤	禾干八
瑾	王廿口丰
藻	艹氵口口口木
螺	虫田糸
恤	心丿皿
污	氵一丂
涯	氵厂土土
滋	氵䒑幺幺
嗜	口耂匕日
陡	阝走
栗	西木
朔	䒑屮月
淇	氵甘廾
捻	扌亼㇕心
勃	十冖子力
矩	矢匚コ
沽	氵十口
淤	氵方人冫
描	扌艹田
契	丰刀大
靳	革斤
祠	示㇕一口
峻	山厶八夂
稠	禾用口
爵	爪四艮寸
秉	禾彐
刨	勹巳刂
雍	亠乚凵隹
群	尹口羊
役	行殳
烙	火夂口
灾	宀火
强	弓口虫
痘	疒一口䒑
髓	骨之𠂇工月
嫣	女一止一乚火
募	艹日大力
苟	艹勹口
析	木斤
魁	鬼冫十
斥	斤丶
棕	木宀示
匡	匚王
倦	亻半卩
疆	弓土三田田
蔓	艹日四又
牟	厶牛
芷	艹止
霆	雨廴亻土
靴	革亻匕
眸	目厶牛
烟	火圍大
巾	巾
殊	一夕𠂉木
叮	口丁
晟	日戊㇕
艇	舟廴亻土
熔	火穴人口
裘	十⺍丶衣
芹	艹斤
寡	宀頁刀
迥	之冂口
瞬	目爪冖夕㐄
邑	口巴
榕	木穴人口
庸	广尹用
棠	小冖口木
仨	亻三
祺	示甘廾
埠	土丿㠯十
酚	酉八刀
茬	艹一亻土
珂	王丁口
嗅	口自犬
佰	亻一白
滇	氵十目廾
寅	宀一由八
婧	女丰月
梵	木木凡
蛾	虫手戈
慰	尸示寸心
履	尸行𠂉日夂
宛	宀夕卩
嫖	女西示
肽	月大丶
涮	氵尸巾刂
督	上小又目
衍	行氵
廿	廿
摁	扌圍大心
劣	小丿力
祈	示斤
魄	白鬼
崽	山田心
斧	八乂斤
裔	衣冂八口
湛	氵甘匚八
琛	王冖八木
淌	氵小冂口
簇	竹方𠂉矢
沛	氵一巾
掠	扌亠口小
崎	山大丁口
菇	艹女十口
砌	石七刀
眯	目米
辱	辰寸
匠	匚斤
肘	月寸
淹	氵大申
洽	氵亼口
溟	氵冖日亠八
究	穴九
矢	矢
澈	氵亠厶月攵
瞥	巾⺍攵目
坨	土宀匕
椰	木耳阝
梢	木小月
嘟	口耂阝
障	阝立日十
霄	雨小月
揣	扌山而
槐	木鬼
粟	西米
唆	口厶八夂
札	木乚
拴	扌人王
吏	一口乂
堰	土匚日女
棺	木宀㠯
腥	月日生
胞	月勹巳
韶	立日召
阜	丿㠯十
剖	立口刂
羹	羊火羊大
剃	弋弓刂
寓	宀日冂厶
峪	山八人口
煜	火日立
撩	扌一火日小
扳	扌𠂆又
桔	木士口
臧	戈爿臣
喀	口宀夂口
妄	亡女
陌	阝一白
弧	弓瓜
弩	女又弓
撰	扌巳巳艹廾
瞿	目目隹
卞	亠卜
蛤	虫亼口
襄	衣口口甘
擒	扌人亠乂凵冂厶
哨	口小月
皂	白七
佘	人示
汞	工水
芭	艹巴
懿	士冖一口䒑冫欠心
椒	木上小又
戎	戈𠂇
肋	月力
翎	亼龴习习
煌	火白王
疤	疒巴
瀚	氵十日十人习习
泓	氵弓厶
昧	日二木
柒	氵七木
旨	匕日
巳	巳
辜	十口辛
筐	竹匚王
膊	月甫寸
遵	之八酉寸
嗒	口艹亼口
剁	几木刂
愧	心鬼
拙	扌屮凵
竿	竹干
圭	土土
甸	勹田
衷	衣中
脊	⺍人月
憨	㇕耳攵心
搽	扌艹人木
捶	扌千艹二
毓	𠂉母亠厶川
苔	艹厶口
奸	女干
坂	土𠂆又
黏	禾人水卜口
甭	不用
瞟	目西示
舅	臼田力
阪	阝𠂆又
恕	女口心
啼	口亠八冖巾
睹	目耂
疲	疒皮
褪	衤之艮
鞠	革勹米
釉	釆由
彰	立日十彡
酬	酉⺍川
橘	木予丿冂八口
啪	口扌白
睛	目丰月
遁	之𠂆十目
哆	口夕夕
窟	穴尸屮凵
垢	土𠂆一口
愿	厂白小心
奚	爪幺大
褚	衤耂
腮	月田心
枉	木王
涓	氵口月
嗟	口羊工
笙	竹生
沸	氵弓刂
妓	女十又
猿	犭土口衤
漠	氵艹日大
撬	扌毛毛毛
巍	山禾女鬼
漾	氵羊丶水
擎	艹勹口攵手
靶	革巴
俐	亻禾刂
胚	月不一
楷	木匕匕白
迭	之手丶
嗣	口冊㇕一口
嵩	山亠口冂口
蹄	足亠八冖巾
褐	衤日勹亡
丞	㇕水一
芮	艹冂人
梭	木厶八夂
唷	口亠厶月
曜	日习习隹
畜	亠幺田
砼	石人工
粽	米宀示
唑	口人人土
宵	宀小月
榆	木亼月刂
嚷	口衣口口甘
焱	火火火
絮	女口糸
戊	戊
罕	冖八干
叩	口卩
俯	亻广亻寸
瀑	氵日艹廾水
肇	户攵彐キ
毋	母丿
摞	扌田糸
暇	日尸二コ又
岐	山十又
睬	目爪木
郊	亠八乂阝
璧	尸口辛王丶
捎	扌小月
汶	氵文
嘀	口亠八冂十口
犁	禾刂牛
怔	心一止
焚	木木火
恁	亻丿士心
癖	疒尸口辛
灼	火勹丶
孽	艹丿㠯辛子
岱	亻弋山
麓	木木鹿
匙	日一止匕
嚎	口亠口冖豕
爻	乂乂
珏	王王丶
摧	扌山隹
械	木戈廾
乞	𠂉乙
卯	卯
凋	冫用口
蕙	艹一日厶心
噗	口业半大
硒	石西
嗔	口十目廾
卟	口卜
筠	竹土勹冫
咔	口上卜
喧	口宀二日
瓢	西示瓜
裳	小冖口衣
晤	日二乂口
竭	立日勹亡
妨	女方
玻	王皮
宸	宀辰
擅	扌亠圍口日一
烹	亠口了火
卉	十艹
括	扌舌
檐	木𠂊厂八言
戟	十日十戈
尸	尸
椎	木隹
恬	心舌
胥	足月
檀	木亠圍口日一
坯	土不一
葡	艹勹甫
仄	厂人
溴	氵自犬
姝	女𠂉木
伙	亻火
垣	土二日
拘	扌勹口
呱	口瓜
昱	日立
箍	竹扌匚巾
躁	足口口口木
噬	口竹工人人
孚	爪子
玥	王月
蓓	艹亻立口
蛆	虫且
囚	圍人
鞘	革小月
匣	匚甲
凳	癶一口䒑几
隙	阝小日小
娣	女弋弓
莞	艹宀一兀
荃	艹人王
伶	亻亼龴
拭	扌弋工
墅	田土予土
懵	心艹四冖目
苷	艹甘
碾	石尸廿衤
禧	示士口䒑口
囡	圍女
榨	木穴𠂉匕
黯	四土火立日
荼	艹亼木
苞	艹勹巳
戚	戊上小
倘	亻小冂口
怯	心土厶
礁	石隹火
瞻	目𠂊厂八言
躬	身弓
脖	月十冖子
襟	衤木木示
尉	尸示寸
亥	亠凵人
肢	月十又
悄	心小月
弋	弋
厘	厂田土
憎	心八四日
砷	石申
糙	米之牛口
炯	火冂口
莘	艹辛
盔	𠂇火皿
睦	目土八土
仟	亻千
炕	火亠几
荔	艹力力力
嗷	口丰力攵
盅	中皿
藩	艹氵釆田
奢	大耂
尬	尤亻八
趾	足止
悼	心卜日十
抿	扌巳七
憾	心戊一口心
孓	了丶
浣	氵宀一兀
兀	兀
囿	圍𠂇月
稚	禾隹
褒	衣亻口木
痔	疒土寸
烘	火艹廾
渭	氵田月
嘻	口士口䒑口
喏	口艹𠂇口
町	田丁
麒	鹿甘廾
熄	火自心
烯	火乂𠂇巾
艮	艮
珉	王巳七
捋	扌爪寸
薯	艹四耂
蕉	艹隹火
荀	艹勹日
逍	之小月
冼	冫牛儿
泪	氵目
拗	扌幺力
毯	毛火火
邸	氏丶阝
炙	䏑火
倭	亻禾女
翊	立习习
莽	艹犬廾
笠	竹立
勉	召儿力
亢	亠几
羌	羊儿
璋	王立日十
咚	口夂冫
恪	心夂口
涌	氵龴用
妒	女户
醯	酉亠厶川皿
圩	土丁一
暑	日耂
疫	疒殳
歉	禾禾彐欠
汐	氵夕
樟	木立日十
豁	宀丰口八人口
窖	穴牛口
脉	月丶水
启	户口
扭	扌彐丨
胰	月大弓
泗	氵四
帘	穴巾
隅	阝日冂厶
葆	艹亻口木
岔	八刀山
歆	立日欠
弛	弓也
秘	禾弋八
渚	氵耂
畀	田廾
撼	扌戊一口心
痞	疒不口
瘟	疒日皿
樽	木八酉寸
歧	止十又
椿	木丰日
确	石𠂊用
咀	口且
价	亻亻八
寮	宀一火日小
蒿	艹亠口冂口
醛	酉艹人王
悍	心日干
硼	石月月
啤	口鬼十
壬	丿士
叛	半𠂆又
浚	氵厶八夂
獒	丰力攵犬
捌	扌口力刂
勘	甘匚八力
剌	木口刂
樵	木隹火
啄	口豕
倡	亻日日
肛	月工
糜	广木木米
漪	氵犭大丁口
瑕	王尸二コ又
蔽	艹巾⺍攵
糯	米雨而
茫	艹氵亡
噎	口士冖一口䒑
凰	几白王
溺	氵弓冫弓冫
寰	宀四一口衤
璞	王业半大
霓	雨臼儿
醚	酉之米
硝	石小月
囤	圍一屮
吭	口亠几
靡	广木木非
厥	厂䒑屮欠
跺	足几木
沓	水日
忻	心斤
遛	之卯田
萃	艹亠人人十
埔	土甫
扼	扌厂卩
吱	口十又
竺	竹二
霏	雨非
蛟	虫亠八乂
圃	圍甫
晗	日亼㇕口
泠	氵亼龴
瘸	疒力口䏑
琢	王豕
酉	酉
棘	木冂木冂
蚌	虫丰
疣	疒尤
恍	心小兀
糠	米广尹⺍
渺	氵目小丿
洙	氵𠂉木
瀛	氵亡口月女凡
祀	示巳
琅	王丶艮
攥	扌竹目大糸
苛	艹丁口
苓	艹亼龴
丕	不一
唬	口虎
夭	丿大
腌	月大申
橡	木召豕
嗄	口頁夂
眩	目亠幺
弈	大八廾
珞	王夂口
拈	扌卜口
茸	艹耳
倔	亻尸屮凵
貂	豸召
丰	丰
耙	耒巴
跋	足犬㇕
踱	足广廿又
叭	口八
恢	心𠂇火
彝	彑米糸廾
旌	方𠂉生
濮	氵亻业半大
孜	子攵
琨	王日匕匕
琰	王火火
舵	舟宀匕
寐	宀爿二木
璃	王亠乂凵冂厶
荻	艹犭火
孬	不女子
懈	心𠂊用刀牛
漕	氵一曲日
磐	舟殳石
宦	宀臣
撅	扌厂䒑屮欠
罡	四一止
漱	氵木口欠
庶	广廿火
釜	八乂王八
焯	火卜日十
熵	火亠八冂八口
挎	扌大一丂
茉	艹一木
匾	匚户冊
筑	竹工凡
膳	月羊䒑口
濡	氵雨而
痹	疒田廾
恃	心土寸
淞	氵木八厶
舀	爪臼
搔	扌又丶虫
梧	木二乂口
匝	匚巾
哌	口𠂆亻
屹	山𠂉乙
侑	亻𠂇月
灸	𠂊丶火
熹	士口䒑火
焙	火立口
蹈	足爪臼
牡	牛土
秧	禾冂大
狸	犭田土
沼	氵召
夯	大力
毗	田匕匕
炬	火匚コ
逞	之口王
簧	竹廿由八
脲	月尸水
窘	穴尹口
赦	土火攵
蔫	艹一止一乚火
柚	木由
煨	火田衤
溯	氵䒑屮月
宙	宀由
薹	艹士口冖至
斟	甘匚八冫十
柑	木甘
匿	匚艹𠂇口
剔	日勿刂
崴	山戊一女
胯	月大一丂
眷	半目
癸	癶一大
嘲	口十日十月
噤	口木木示
噩	王口口口口
蟒	虫艹犬廾
燮	言火火又
汲	氵𠂊又
筷	竹心㇕大
侄	亻至
滔	氵爪臼
姣	女亠八乂
丐	下乚
戌	戊一
敝	巾⺍攵
疹	疒人彡
炊	火欠
涕	氵弋弓
摹	艹日大手
杵	木午
棣	木尹⺍
羚	羊亼龴
渤	氵十冖子力
墟	土虎业
柿	木亠巾
烷	火宀一兀
蹙	戊上小足
噪	口口口口木
璟	王日亠口小
氖	气㇕丿
攸	亻丨攵
帛	白巾
膨	月士口䒑彡
甬	龴用
琉	王亠厶川
抒	扌予
酌	酉勹丶
榭	木身寸
沅	氵一兀
濠	氵亠口冖豕
嬉	女士口䒑口
殖	一夕十目
珀	王白
眶	目匚王
稼	禾宀豕
咎	夂卜口
潞	氵足夂口
莓	艹𠂉母
嘈	口一曲日
馥	禾日𠂉日夂
皋	白大十
粹	米亠人人十
祗	示氏丶
褂	衤土土卜
娼	女日日
叟	臼丨又
廓	广亠口子阝
弼	弓一白弓
珈	王力口
旻	日文
翡	非习习
曳	申丿
偕	亻匕匕白
羲	羊禾戈丂
汾	氵八刀
陂	阝皮
蛹	虫龴用
郅	至阝
啖	口火火
豚	月豕
湄	氵尸目
熨	尸示寸火
犀	尸水牛
咂	口匚巾
糗	米自犬
吡	口匕匕
冕	冖二召儿
褶	衤习习白
垛	土几木
髻	長彡士口
擂	扌雨田
芊	艹千
檬	木艹冖一豕
咕	口十口
嘶	口甘廾斤
昀	日勹冫
疝	疒山
尻	尸九
孑	了一
坳	土幺力
槌	木之丿㠯
吮	口厶儿
厂	厂
芋	艹丁一
萎	艹禾女
榻	木日习习
嗡	口八厶习习
妤	女予
墒	土亠八冂八口
瑄	王宀二日
隼	隹十
吠	口犬
幡	巾釆田
篷	竹之夂丰
伢	亻牙
仂	亻力
沂	氵斤
尕	㇕丿小
聆	耳亼龴
嗑	口土厶皿
漳	氵立日十
沱	氵宀匕
卅	一川
碌	石彐水
偈	亻日勹亡
蒽	艹圍大心
怠	厶口心
杠	木工
砰	石干八
曙	日四耂
稽	禾尤匕日
簪	竹旡旡日
偎	亻田衤
恙	羊心
敞	小冂口攵
徙	行止止
嬴	亡口月女凡
祚	示𠂉匕
巽	巳巳艹廾
拇	扌母
兢	十口儿十口儿
踮	足广卜口
汕	氵山
亓	一廾
啜	口又又又又
氰	气丰月
壑	卜冖一八人口又土
嗪	口丰禾
呤	口亼龴
峨	山手戈
濂	氵广禾禾彐
姊	女丿乚亻
敕	木口攵
愉	心亼月刂
溥	氵甫寸
鄢	一止一乚火阝
罔	冂䒑亡
衙	行二乂口
厝	厂廿日
鄙	口十圍口阝
桀	夕㐄木
澎	氵士口䒑彡
宥	宀𠂇月
聿	彐キ
骸	骨亠凵人
煽	火户习习
狙	犭且
惶	心白王
酣	酉甘
杳	木日
煦	日勹口火
庇	广匕匕
芥	艹亻八
苡	艹厶人
戍	戈人
蝗	虫白王
暄	日宀二日
床	广木
泯	氵巳七
陋	阝一冂人乚
戮	习习人彡戈
壤	土衣口口甘
墉	土广尹用
揖	扌口耳
菡	艹了⺍凵
伎	亻十又
愕	心口口一丂
呷	口甲
唧	口艮卩
烽	火夂丰
慨	心艮旡
乒	丘丿
朦	月艹冖一豕
粱	氵刀八米
宓	宀弋八
峙	山土寸
侗	亻冂一口
征	行一止
畦	田土土
骶	骨氏丶
膘	月西示
庾	广臼人
淬	氵亠人人十
掖	扌亠亻夂丶
柬	木四
逵	之土八土
秩	禾手丶
湜	氵日一止
蕃	艹釆田
朽	木丂
杞	木巳
蛛	虫𠂉木
啡	口非
晦	日𠂉母
傈	亻西木
昶	丶水日
痂	疒力口
扉	户非
嫉	女疒矢
广	广
垠	土艮
萘	艹大示
蜷	虫半卩
嗤	口屮一虫
幌	巾日小兀
篆	竹彑豕
臼	臼
怖	心𠂇巾
灶	火土
宁	宀丁
裱	衤丰衤
扈	户口巴
嫡	女亠八冂十口
磬	士尸殳石
嗖	口臼丨又
哺	口甫
踝	足田木
叱	口匕
婢	女鬼十
婿	女足月
擀	扌十日十人干
挽	扌召儿
歹	一夕
矗	十目十目十目
叨	口刀
喙	口彑豕
晰	日木斤
晁	日儿⺍
箐	竹丰月
鼬	臼釆由
揩	扌匕匕白
砣	石宀匕
偃	亻匚日女
氐	氏丶
迸	之䒑廾
酪	酉夂口
咿	口亻尹
幔	巾日四又
淖	氵卜日十
渥	氵尸至
瑰	王鬼
蔗	艹广廿火
嗓	口又又又木
郜	牛口阝
膛	月小冖口土
孢	子勹巳
涔	氵山亼㇕
浠	氵乂𠂇巾
汛	氵乙十
剿	巛田木刂
噌	口八四日
掣	牛巾刂手
娑	氵小丿女
蔬	艹足亠厶川
枷	木力口
啉	口木木
俑	亻龴用
腋	月亠亻夂丶
灞	氵雨革月
吆	口幺
舫	舟方
羿	习习廾
璜	王廿由八
拄	扌丶王
郴	木木阝
蟾	虫𠂊厂八言
腚	月宀一止
吝	文口
沏	氵七刀
穹	穴弓
嘌	口西示
岫	山由
筵	竹廴丿止
矜	予丿亼㇕
掬	扌勹米
皿	皿
纂	竹目大糸
徊	行圍口
焗	火尸㇕口
撂	扌田夂口
嗽	口木口欠
悖	心十冖子
耘	耒二厶
蜃	辰虫
郢	口王阝
罘	四不
雒	夂口隹
勐	子皿力
蔻	艹宀一兀卜又
榴	木卯田
伺	亻㇕一口
胜	月生
榛	木丰禾
筏	竹亻戈
淅	氵木斤
澹	氵𠂊厂八言
辟	尸口辛
姥	女耂匕
嗝	口一口冂八丁
粕	米白
甾	巛田
坷	土丁口
仆	亻卜
佚	亻手丶
脯	月甫
痢	疒禾刂
煸	火户冊
汰	氵大丶
濯	氵习习隹
萼	艹口口一丂
楔	木丰刀大
呲	口止匕
唰	口尸巾刂
疃	田立田土
煊	火宀二日
圳	土川
洵	氵勹日
犟	弓口虫牛
槎	木羊工
峭	山小月
猥	犭田衤
惺	心日生
楣	木尸目
僚	亻一火日小
忿	八刀心
孵	卯丶丶爪子
紊	文糸
罄	士尸殳午凵
髯	長彡冂土
捺	扌大示
懋	木予丿木心
帷	巾隹
雉	矢隹
舸	舟丁口
膈	月一口冂八丁
寞	宀艹日大
蹇	宀甘八足
蚜	虫牙
畸	田大丁口
箕	竹甘廾
匆	勿丶
壕	土亠口冖豕
堇	廿口丰
蕞	艹日耳又
涎	氵廴丿止
渲	氵宀二日
耽	耳冖儿
菅	艹宀㠯
猩	犭日生
疵	疒止匕
遐	之尸二コ又
袂	衤㇕大
霾	雨豸田土
虔	虎文
蹴	足亠口小尤
舶	舟白
燎	火一火日小
熠	火习习白
殃	一夕冂大
噼	口尸口辛
遏	之日勹亡
舛	夕㐄
匕	匕
隘	阝䒑八皿
喈	口匕匕白
澍	氵士口䒑寸
珩	王行
畈	田𠂆又
衢	行目目隹
泌	氵弋八
宕	宀石
邈	之豸白儿
苄	艹亠卜
菀	艹宀夕卩
岷	山巳七
俘	亻爪子
衾	亼㇕衣
狩	犭宀寸
蠡	彑豕虫虫
邰	厶口阝
殆	一夕厶口
鬃	長彡宀示
啶	口宀一止
晌	日宀口
睫	目一彐止
獾	犭艹口口隹
捍	扌日干
芾	艹一巾
彧	弋口一彡
蝠	虫一口田
嘣	口山月月
岢	山丁口
靛	丰月宀一止
莆	艹甫
氦	气亠凵人
佯	亻羊
膀	月亠八冖方
姻	女圍大
葭	艹尸二コ又
耆	耂匕日
夙	几一夕
腑	月广亻寸
樾	木走戈乚
咣	口小兀
噙	口人亠乂凵冂厶
猝	犭亠人人十
潼	氵立田土
窒	穴至
翌	习习立
夔	八頁止巳夂
髂	骨宀夂口
熏	千四二火
刈	乂刂
舷	舟亠幺
肟	月一丂
氓	亡巳七
豢	半豕
忱	心冖儿
洧	氵𠂇月
雇	户隹
媳	女自心
蠹	一中冖石虫虫
荐	艹一亻子
蟮	虫羊䒑口
庖	广勹巳
埂	土一日乂
琥	王虎
哏	口艮
俟	亻厶矢
抻	扌申
缶	午凵
汴	氵亠卜
忝	一大心
璨	王卜夕又米
喱	口厂田土
嵇	禾尤山
怵	心木丶
湍	氵山而
葳	艹戊一女
藜	艹禾丿刀人水
僻	亻尸口辛
瓤	衣口口甘瓜
羯	羊日勹亡
澶	氵亠圍口日一
拯	扌㇕水一
芡	艹欠
枰	木干八
俸	亻丰キ
翱	白大十习习
奠	八酉大
肱	月𠂇厶
屙	尸阝丁口
邕	巛口巴
埒	土爪寸
茱	艹𠂉木
槿	木廿口丰
楹	木㇕丿又皿
蛭	虫至
哽	口一日乂
髁	骨田木
骰	骨殳
氡	气夂冫
飧	夕食
翩	户冊习习
祟	屮凵示
殉	一夕勹日
塬	土厂白小
琬	王宀夕卩
剋	十口儿刂
芩	艹亼㇕
硎	石一廾刂
峁	山卯
淦	氵金
苒	艹冂土
箔	竹氵白
洎	氵自
跤	足亠八乂
嗌	口䒑八皿
牲	牛生
牒	爿廿乚木
漩	氵方𠂉足
玳	王亻弋
芪	艹氏
皙	木斤白
僳	亻西米
胍	月瓜
涸	氵圍十口
攘	扌衣口口甘
嚄	口艹隹又
剜	宀夕卩刂
圻	土斤
苣	艹匚コ
芍	艹勹丶
菩	艹立口
哂	口西
佣	亻用
仞	亻刀丶
冽	冫一夕刂
耦	耒日冂厶
桉	木宀女
粲	卜夕又米
喳	口木日一
啐	口亠人人十
庋	广十又
粑	米巴
鋈	氵丿大金
戾	户犬
亟	了口又一
蘑	艹广木木石
跛	足皮
憬	心日亠口小
愀	心禾火
湮	氵西土
洇	氵圍大
祜	示十口
饕	口丂虎食
盹	目一屮
畲	人示田
寤	宀爿二乂口
娉	女由丂
硌	石夂口
盎	冂大皿
睢	目隹
斛	𠂊用冫十
泮	氵半
汊	氵又丶
碴	石木日一
哮	口耂子
嘬	口日耳又
嶂	山立日十
乓	丘丶
逯	之彐水
枳	木口八
杓	木勹丶
岬	山甲
埭	土尹⺍
螯	丰力攵虫
孛	十冖子
啷	口丶艮阝
笥	竹㇕一口
狡	犭亠八乂
竦	立木口
硐	石冂一口
蹶	足厂䒑屮欠
蹋	足日习习
篡	竹目大厶
俚	亻田土
恣	冫欠心
羧	羊厶八夂
胄	由月
禺	日冂厶
笆	竹巴
竣	立厶八夂
甑	八四日瓦
悸	心禾子
韭	非一
暝	日冖日亠八
凼	水凵
睨	目臼儿
倌	亻宀㠯
肪	月方
馗	九八頁
孺	子雨而
琮	王宀示
芫	艹一兀
秸	禾士口
皎	白亠八乂
煅	火厂三殳
慵	心广尹用
耨	耒辰寸
蜇	扌斤虫
莒	艹口口
蘅	艹行𠂊田大
苕	艹召
橇	木毛毛毛
翳	匚矢殳习习
哐	口匚王
崛	山尸屮凵
篁	竹白王
偌	亻艹𠂇口
庵	广大申
炷	火丶王
洳	氵女口
隧	阝之八豕
茆	艹卯
蜈	虫口一大
喹	口大土土
澧	氵曲一口䒑
姒	女厶人
柘	木石
枋	木方
虻	虫亡
惰	心𠂇工月
洮	氵儿氵
蚤	又丶虫
婊	女丰衤
斡	十日十人冫十
栩	木习习
哧	口土火
僖	亻士口䒑口
傣	亻丰水
倏	亻丨攵犬
苹	艹干八
蕨	艹厂䒑屮欠
茴	艹圍口
藐	艹豸白儿
酵	酉耂子
蛔	虫圍口
崮	山圍十口
膦	月米夕㐄
匈	勹乂凵
洹	氵二日
璁	王囟夂心
蒯	艹月月刂
椋	木亠口小
叵	匚口
唾	口千艹二
噔	口癶一口䒑
惚	心勿心
瑙	王巛囟
棹	木卜日十
蜥	虫木斤
蛀	虫丶王
螟	虫冖日亠八
唏	口乂𠂇巾
畹	田宀夕卩
黍	禾人水
腓	月非
庥	广亻木
貉	豸夂口
妊	女丿士
荇	艹行
蔸	艹白卯儿
艿	艹㇕丿
斫	石斤
咻	口亻木
箴	竹戊一口
适	之舌
淙	氵宀示
嫦	女小冖口巾
弁	厶廾
萜	艹巾卜口
薏	艹立日心
趺	足夫
郗	乂𠂇巾阝
虢	爪寸虎
慷	心广尹⺍
寥	宀习习人彡
邯	甘阝
蔑	艹四戈人
楮	木耂
砥	石氏丶
迄	之𠂉乙
儆	亻艹勹口攵
臊	月口口口木
咫	尸丶口八
鍪	予丿攵金
婺	予丿攵女
搪	扌广尹口
葑	艹土土寸
噫	口立日心
瞰	目㇕耳攵
僮	亻立田土
佗	亻宀匕
塾	亠口子丸土
旎	方𠂉尸匕
壅	亠乚凵隹土
懦	心雨而
酆	丰丰山一口䒑阝
箬	竹艹𠂇口
爰	爪一𠂇又
炔	火㇕大
妲	女日一
蓼	艹习习人彡
螭	虫亠乂凵冂厶
峒	山冂一口
觥	𠂊用小兀
羔	羊火
熘	火卯田
衿	衤亼㇕
盂	丁一皿
髦	長彡毛
萸	艹臼人
踞	足尸十口
昴	日卯
卮	𠂆一卩
湫	氵禾火
娓	女尸毛
恚	土土心
莜	艹亻丨攵
魑	鬼亠乂凵冂厶
汜	氵巳
榫	木隹十
椽	木彑豕
蟠	虫釆田
蹊	足爪幺大
晞	日乂𠂇巾
詈	四言
肴	乂𠂇月
獠	犭一火日小
痿	疒禾女
焓	火亼㇕口
湃	氵手一丰
湟	氵白王
祉	示止
妗	女亼㇕
菘	艹木八厶
菏	艹氵丁口
啻	亠八冖巾口
旖	方𠂉大丁口
饔	亠乚凵隹食
劭	召力
姘	女䒑廾
畿	幺幺戈田
坭	土尸匕
霈	雨氵一巾
呔	口大丶
箸	竹耂
稔	禾亼㇕心
乂	乂
塍	月半土
庹	广廿尸丶
疚	疒𠂊丶
怛	心日一
窿	穴阝夂一生
霰	雨廿月攵
噘	口厂䒑屮欠
啾	口禾火
俅	亻十⺍丶
腱	月廴彐キ
瘁	疒亠人人十
漓	氵亠乂凵冂厶
迂	之丁一
菰	艹子瓜
碇	石宀一止
嗬	口艹亻丁口
笄	竹一廾
凇	冫木八厶
洌	氵一夕刂
袒	衤日一
鄄	西土阝
呋	口夫
唳	口户犬
篙	竹亠口冂口
氛	气八刀
垃	土立
蚴	虫幺力
跖	足石
踉	足丶艮
佃	亻田
腈	月丰月
腊	月廿日
膺	广亻隹月
焐	火二乂口
洱	氵耳
衲	衤冂人
蛩	工凡虫
琶	王王巴
菟	艹召儿丶
稷	禾田八夂
笈	竹𠂊又
螅	虫自心
嚯	口雨隹
篪	竹𠂆虎
沮	氵且
挹	扌口巴
逑	之十⺍丶
鞅	革冂大
蚧	虫亻八
笏	竹勿
酋	八酉
鎏	氵亠厶川金
滁	氵阝亼木
媸	女屮一虫
并	䒑廾
苫	艹卜口
楸	木禾火
迓	之牙
蛘	虫羊
踵	足千日土
炅	日火
罹	四心隹
肼	月二刂
旃	方𠂉冊丶
懊	心宀米大
涫	氵宀㠯
遽	之虎豕
陛	阝匕匕土
觳	士冖一𠂊用殳
揸	扌木日一
萄	艹勹午凵
薜	艹尸口辛
崆	山穴工
脘	月宀一兀
舂	丰臼
达	之大
唇	辰口
豕	豕
嵊	山禾北
况	冫口儿
褰	宀甘八衣
冗	冖几
薨	艹四冖一夕匕
椴	木厂三殳
雎	且隹
腩	月十冂半
瘴	疒立日十
芎	艹弓
酊	酉丁
笞	竹厶口
侮	亻𠂉母
胱	月小兀
肓	亡月
痧	疒氵小丿
袢	衤半
髡	長彡兀
擢	扌习习隹
嘁	口戊上小
罅	午凵虎爪丁
佼	亻亠八乂
亳	亠口冖丿七
悴	心亠人人十
梆	木丰阝
乩	卜口乚
呶	口女又
疽	疒且
淄	氵巛田
逅	之𠂆一口
逄	之夂㐄
菽	艹上小又
蓖	艹囟匕匕
菔	艹月卩又
蟆	虫艹日大
嘭	口士口䒑彡
尜	小大小
嵋	山尸目
佤	亻瓦
鼾	自田廾干
猷	八酉犬
萁	艹甘廾
葩	艹白巴
蛐	虫曲
勖	冖二目力
笪	竹日一
舐	舌氏
佶	亻士口
倨	亻尸十口
溉	氵艮旡
赭	土火耂
檠	艹勹口攵木
桅	木𠂊厂卩
訾	止匕言
嘹	口一火日小
庠	广羊
杈	木又丶
砧	石卜口
蛉	虫亼龴
蟀	虫亠幺⺍十
惕	心日勿
惘	心冂䒑亡
惦	心广卜口
潦	氵一火日小
窠	穴田木
裨	衤鬼十
迨	之厶口
矸	石干
蜓	虫廴亻土
蚩	屮一虫
耒	耒
芄	艹丸
榷	木冖隹
奄	大申
碚	石立口
喑	口立日
繇	爪午凵丿糸
裾	衤尸十口
窈	穴幺力
豉	一口䒑十又
劾	亠凵人力
憧	心立田土
嫠	二木攵厂女
琇	王禾㇕丿
荏	艹亻丿士
杪	木小丿
榔	木丶艮阝
旆	方𠂉一巾
燧	火之八豕
遑	之白王
橐	一中冖石木
圪	土𠂉乙
槭	木戊上小
棰	木千艹二
嗥	口白大十
岣	山勹口
魈	鬼小月
珥	王耳
砭	石丿之
碓	石隹
蟑	虫立日十
蚓	虫弓丨
嗵	口之龴用
嵴	山⺍人月
憩	舌自心
昝	夂卜日
隗	阝鬼
琚	王尸十口
葫	艹十口月
鞣	革予丿木
醴	酉曲一口䒑
嵛	山亼月刂
牯	牛十口
簟	竹西日十
笮	竹𠂉匕
麝	鹿身寸
沌	氵一屮
勰	力力力田心
婀	女阝丁口
瑁	王冖二目
綦	甘廾糸
喋	口廿乚木
瓴	亼龴瓦
毖	匕匕弋八
愫	心丰糸
悚	心木口
搴	宀甘八手
醪	酉习习人彡
趿	足𠂊又
嗍	口䒑屮月
杲	日木
骷	骨十口
爨	臼冂一口冖木木大火
羸	亡口月羊凡
攫	扌目目隹又
茼	艹冂一口
圜	圍四一口衤
秣	禾一木
僭	亻旡旡日
囟	囟
慊	心禾禾彐
汨	氵日
譬	尸口辛言
摒	扌尸䒑廾
嘧	口宀弋八山
嵬	山鬼
瞑	目冖日亠八
氪	气十口儿
笳	竹力口
魃	鬼犬㇕
浯	氵二乂口
溱	氵丰禾
阡	阝千
璩	王虎豕
醮	酉隹火
蠊	虫广禾禾彐
圉	圍土半
嚓	口宀䏑又示
豺	豸十丿
獐	犭立日十
旄	方𠂉毛
泖	氵卯
溏	氵广尹口
裉	衤艮
芟	艹殳
柜	木匚コ
蚨	虫夫
俎	人人且
肫	月一屮
糍	米䒑幺幺
槊	䒑屮月木
涑	氵木口
涪	氵立口
漉	氵鹿
彗	丰丰彐
泱	氵冂大
泫	氵亠幺
帚	彐冖巾
埕	土口王
瑗	王爪一𠂇又
茁	艹屮凵
檄	木白方攵
竽	竹丁一
稗	禾鬼十
咨	冫欠口
淀	氵宀一止
謇	宀甘八言
逖	之犭火
靼	革日一
唵	口大申
吩	口八刀
哞	口厶牛
迤	之𠂉也
佞	亻二女
郯	火火阝
邋	之巛圍乂巛
垌	土冂一口
璀	王山隹
蹩	巾⺍攵足
昉	日方
涿	氵豕
鼐	㇕丿目爿爿
戛	頁戈
芨	艹𠂊又
蠓	虫艹冖一豕
蚪	虫冫十
瞋	目十目廾
倥	亻穴工
褥	衤辰寸
嬖	尸口辛女
孀	女雨木目
珣	王勹日
璘	王米夕㐄
菠	艹氵皮
卣	卜圍コ
跚	足冊
嶷	山匕矢龴足
牖	爿户甫
徨	行白王
豸	豸
溧	氵西木
阱	阝二刂
皴	厶八夂皮
踔	足卜日十
黜	四土火屮凵
淝	氵月巴
虺	兀虫
磋	石羊工
蠖	虫艹隹又
吽	口牛
徘	行非
粼	米夕㐄巛
烊	火羊
蓑	艹衣口一
酢	酉𠂉匕
醌	酉日匕匕
樘	木小冖口土
楦	木宀二日
蜒	虫廴丿止
胂	月申
忤	心午
艽	艹九
蜡	虫廿日
蚝	虫毛
癜	疒尸艹廾殳
沭	氵木丶
滓	氵宀辛
娌	女田土
鏊	丰力攵金
葶	艹亠口冖丁
酞	酉大丶
榱	木衣口一
煳	火十口月
嫚	女日四又
柰	木示
桁	木行
蜱	虫鬼十
恫	心冂一口
憔	心隹火
剡	火火刂
彀	士冖一弓殳
雹	雨勹巳
橄	木㇕耳攵
蟛	虫士口䒑彡
咴	口𠂇火
俶	亻上小又
遒	之八酉
衩	衤又丶
圮	土巳
揆	扌癶一大
苤	艹不一
苴	艹且
苻	艹亻寸
婪	木木女
碉	石用口
倬	亻卜日十
奘	爿士大
痱	疒非
疙	疒𠂉乙
浞	氵足
湔	氵䒑月刂
潺	氵尸子子子
袷	衤亼口
爿	爿
鄞	廿口丰阝
劬	勹口力
恿	龴用心
坍	土冊丶
垸	土宀一兀
鬟	長彡四一口衤
耪	耒亠八冖方
芑	艹巳
逋	之甫
蚶	虫甘
曷	日勹亡
侈	亻夕夕
刖	月刂
旒	方𠂉亠厶川
忖	心寸
惆	心用口
掇	扌又又又又
鞫	革勹言
槲	木𠂊用冫十
猗	犭大丁口
沔	氵丁乚㇕
窨	穴立日
厾	乙土厶
耄	耂匕毛
蛄	虫十口
篦	竹囟匕匕
俳	亻非
獬	犭𠂊用刀牛
胝	月氏丶
濉	氵目隹
邃	之穴八豕
屐	尸行十又
殄	一夕人彡
瞽	士口䒑十又目
楝	木木四
耷	大耳
曛	日千四二火
氤	气圍大
臆	月立日心
埸	土日勿
拊	扌亻寸
荑	艹大弓
榧	木匚非
垡	亻戈土
徇	行勹日
腆	月冊廾
胗	月人彡
瘢	疒舟殳
遨	之丰力攵
擤	扌自田廾
匏	大一丂勹巳
蝴	虫十口月
虼	虫𠂉乙
粿	米田木
隳	阝𠂇工月人心
堋	土月月
菹	艹氵且
酐	酉干
哚	口几木
眭	目土土
峰	山夂丰
胛	月甲
腴	月臼人
疳	疒甘
惴	心山而
窕	穴儿⺍
陟	阝止癶
鼙	士口䒑十又鬼十
蕈	艹西日十
楂	木木日一
楫	木口耳
呻	口申
咄	口屮凵
骼	骨夂口
魍	鬼冂䒑亡
狎	犭甲
麾	广木木毛
窣	穴亠人人十
窸	穴釆心
褡	衤艹亼口
嬗	女亠圍口日一
邛	工阝
玎	王丁
瑚	王十口月
椐	木尸十口
蜘	虫矢口
嗉	口丰糸
唁	口言
筮	竹工人人
箜	竹穴工
瓮	八厶瓦
粳	米一日乂
遄	之山而
裰	衤又又又又
鞴	革廿丿用
蘩	艹𠂉母攵糸
碲	石亠八冖巾
跏	足力口
崚	山土八夂
仵	亻午
歙	亼口习习欠
蠲	䒑八皿四勹虫
粞	米西
蟊	予丿虫虫
媲	女囟匕匕
盍	土厶皿
扦	扌千
菪	艹宀石
棱	木土八夂
蛞	虫舌
笤	竹召
傀	亻鬼
胭	月圍大
旮	九日
悻	心土半
埝	土亼㇕心
圯	土巳
栲	木耂丂
砹	石艹乂
跣	足牛儿
邾	𠂉木阝
氚	气川
瓿	立口瓦
潢	氵廿由八
禳	示衣口口甘
鬻	弓米弓一口冂八丁
彘	彑匕矢匕
殛	一夕了口又一
琵	王王匕匕
拮	扌士口
砟	石𠂉匕
笸	竹匚口
邙	亡阝
悌	心弋弓
淠	氵田廾
嫫	女艹日大
妣	女匕匕
餮	一夕人彡食
赳	走凵
埽	土彐冖巾
圾	土𠂊又
薅	艹女辰寸
樗	木雨一丂
柞	木𠂉匕
跆	足厶口
嗐	口宀丰口
嵯	山羊工
牝	牛匕
瘛	疒丰刀心
滂	氵亠八冖方
嫘	女田糸
橛	木厂䒑屮欠
骺	骨𠂆一口
笊	竹爪
倜	亻用口
皈	白𠂆又
怙	心十口
滹	氵虎爪丁
槁	木亠口冂口
酃	雨口口口阝
郾	匚日女阝
畋	田攵
髀	骨鬼十
穰	禾衣口口甘
獗	犭厂䒑屮欠
羰	羊山𠂇火
抉	扌㇕大
莩	艹爪子
柩	木匚𠂊丶
蚰	虫由
螳	虫小冖口土
咆	口勹巳
翕	亼口习习
郄	乂𠂇厶阝
朐	月勹口
夤	夕宀一由八
窳	穴瓜瓜
劼	士口力
踅	扌斤足
蘧	艹之虎豕
杼	木予
蚋	虫冂人
跗	足亻寸
侔	亻厶牛
郇	勹日阝
裎	衤口王
冢	冖豕
陔	阝亠凵人
埵	土千艹二
瑭	王广尹口
醺	酉千四二火
喟	口田月
咐	口亻寸
蜚	非虫
旯	日九
嶙	山米夕㐄
甥	生田力
篾	竹四戈人
皤	白釆田
敫	白方攵
洄	氵圍口
裟	氵小丿衣
弭	弓耳
媾	女甘冂土
莨	艹丶艮
霹	雨尸口辛
邳	不一阝
蟪	虫一日厶心
蚣	虫八厶
跎	足宀匕
嶝	山癶一口䒑
貘	豸艹日大
蝽	虫丰日
恂	心勹日
夬	㇕大
翮	一口冂八丁习习
邴	一冂人阝
玠	王亻八
蕤	艹豕生
蚱	虫𠂉匕
趵	足勹丶
罟	四十口
矍	目目隹又
峋	山勹日
槔	木白大十
磴	石癶一口䒑
畛	田人彡
岈	山牙
犍	牛廴彐キ
臃	月亠乚凵隹
廛	广田土八土
愎	心𠂉日夂
茚	艹臼卩
曩	日衣口口甘
暾	日亠口子攵
罱	四十冂半
湎	氵頁圍
鐾	尸口辛金
炱	厶口火
苜	艹目
藿	艹雨隹
茭	艹亠八乂
霎	雨立女
蜿	虫宀夕卩
昃	日厂人
簸	竹甘廾皮
艋	舟子皿
惋	心宀夕卩
蓁	艹丰禾
泅	氵圍人
搡	扌又又又木
酹	酉爪寸
雩	雨一丂
兕	圍凵儿
帙	巾手丶
簌	竹木口欠
鄱	釆田阝
晷	日夂卜口
筇	竹工阝
脒	月米
炻	火石
泔	氵甘
墀	土尸水牛
挈	丰刀手
衄	丿皿彐丨
痤	疒人人土
惇	心亠口子
溲	氵臼丨又
掾	扌彑豕
崤	山乂𠂇月
仃	亻丁
狷	犭口月
麋	鹿米
逶	之禾女
瓠	大一丂瓜
蚯	虫丘
圊	圍丰月
罨	四大申
簋	竹艮皿
氘	气刂
艄	舟小月
煺	火之艮
璠	王釆田
夼	大川
蠕	虫雨而
蹼	足业半大
暌	日癶一大
眇	目小丿
襦	衤雨而
遢	之日习习
逡	之厶八夂
鬲	一口冂八丁
螫	土火攵虫
酩	酉夕口
砘	石一屮
戢	口耳戈
旰	日干
濞	氵自田廾
蔟	艹方𠂉矢
蕖	艹氵匚コ木
硭	石艹亡
吲	口弓丨
氙	气山
璺	臼冂一口冖王丶
徂	行且
刎	勿刂
燔	火釆田
玦	王㇕大
硇	石囟
跬	足土土
泐	氵阝力
衽	衤丿士
擘	尸口辛手
玢	王八刀
隈	阝田衤
薤	艹一夕非一
剽	西示刂
僰	木冂木冂人
枇	木匕匕
砝	石土厶
囹	圍亼龴
罾	四八四日
仡	亻𠂉乙
儋	亻𠂊厂八言
胙	月𠂉匕
垓	土亠凵人
枸	木勹口
秫	禾木丶
愆	行氵心
瘩	疒艹亼口
疥	疒亻八
迢	之召
隰	阝日幺幺火
畚	厶大田
甏	士口䒑彡瓦
醅	酉立口
梃	木廴亻土
珙	王艹廾
葚	艹甘匚八
萑	艹隹
蚍	虫匕匕
筌	竹人王
捯	扌至刂
摭	扌广廿火
藁	艹亠口冂口木
醢	酉𠂇口皿
烀	火爪丁
坼	土斤丶
糅	米予丿木
莠	艹禾㇕丿
烜	火二日
螂	虫丶艮阝
暹	之日隹
帔	巾皮
佾	亻八月
胳	月夂口
瘠	疒⺍人月
翥	耂习习
聃	耳冂土
酡	酉宀匕
杷	木巴
滃	氵八厶习习
琯	王宀㠯
艨	舟艹冖一豕
薷	艹雨而
柁	木宀匕
黠	四土火士口
迕	之午
鄯	羊䒑口阝
滏	氵八乂王八
碣	石日勹亡
晡	日甫
矬	矢人人土
篼	竹白卯儿
徉	行羊
舴	舟𠂉匕
狒	犭弓刂
麂	鹿几
囔	口一中冖口口甘衤
畎	田犬
毽	毛廴彐キ
湉	氵心舌
纛	丰母目木丿糸
豳	豕豕山
幄	巾尸至
徼	行白方攵
猖	犭日日
癍	疒王文王
悱	心非
孱	尸子子子
柙	木甲
瞠	目小冖口土
侏	亻𠂉木
焜	火日匕匕
坩	土甘
琤	王𠂊尹
茯	艹亻犬
蓿	艹宀亻一白
戡	甘匚八戈
蜻	虫丰月
圄	圍二乂口
猾	犭骨
冲	冫中
戕	爿戈
痊	疒人王
渫	氵廿乚木
迹	之大八
隍	阝白王
鬣	長彡巛圍乂巛
耩	耒甘冂土
醍	酉日一止
桷	木𠂊用
尥	尤勹丶
噱	口虎豕
唿	口勿心
黝	四土火幺力
抔	扌不
柢	木氏丶
蹉	足羊工
愔	心立日
溻	氵日习习
漯	氵田糸
萋	艹一尹女
豨	豕乂𠂇巾
崦	山大申
坌	八刀土
邂	之𠂊用刀牛
蓍	艹耂匕日
磔	石夕㐄木
岌	山𠂊又
亶	亠圍口日一
癯	疒目目隹
褟	衤日习习
菖	艹日日
栳	木耂匕
杌	木兀
桴	木爪子
赧	土火卩又
鋆	土勹冫金
葺	艹口耳
莛	艹廴亻土
幛	巾立日十
汩	氵圍一
胬	女又䏑
儿	儿
玷	王卜口
栖	木西
柝	木斤丶
嚅	口雨而
凭	亻丿士几
佝	亻勹口
疔	疒丁
堍	土召儿丶
髑	骨四勹虫
仫	亻丿厶
韵	立日勹冫
檎	木人亠乂凵冂厶
踊	足龴用
髭	長彡止匕
狍	犭勹巳
匐	勹一口田
陲	阝千艹二
牁	爿丁口
坻	土氏丶
嚏	口十冖田足
佻	亻儿⺍
陬	阝耳又
嗞	口䒑幺幺
盥	臼水皿
汔	氵𠂉乙
荽	艹爪女
桎	木至
蜞	虫甘廾
蛸	虫小月
盱	目丁一
溷	氵圍豕
袈	力口衣
澥	氵𠂊用刀牛
扃	户冂口
耜	耒㠯
叶	口十
徭	行爪午凵
胴	月冂一口
觚	𠂊用瓜
蝰	虫大土土
氅	小冂口攵毛
黥	四土火亠口小
嵫	山䒑幺幺
邶	北阝
堞	土廿乚木
聒	耳舌
蹂	足予丿木
袱	衤亻犬
遴	之米夕㐄
蓐	艹辰寸
郤	八人口阝
嗾	口方𠂉矢
舄	臼勹火
疸	疒日一
悝	心田土
殂	一夕且
墼	車凵殳土
奭	大一白一白
蜩	虫用口
黼	业巾⺍甫
嵖	山木日一
忸	心彐丨
浥	氵口巴
妁	女勹丶
捩	扌户犬
豌	一口䒑宀夕卩
蹚	足小冖口土
竑	立𠂇厶
襞	尸口辛衣
帑	女又巾
髹	長彡亻木
揶	扌耳阝
瞌	目土厶皿
鼯	臼釆二乂口
猱	犭予丿木
縻	广木木糸
怦	心干八
忡	心中
洫	氵丿皿
榖	士冖一木殳
甍	艹四冖瓦
蒗	艹氵丶艮
蝮	虫𠂉日夂
龠	亼口口口冊
痍	疒大弓
邗	干阝
堙	土西土
抨	扌干八
蝌	虫禾冫十
臾	臼人
剞	大丁口刂
眄	目丁乚㇕
淆	氵乂𠂇月
沆	氵亠几
鬈	長彡半卩
酗	酉乂凵
篝	竹甘冂土
伉	亻亠几
徜	行小冂口
貊	豸一白
蕻	艹長艹廾
睽	目癶一大
箅	竹田廾
臌	月士口䒑十又
匍	勹甫
瘌	疒木口刂
姮	女二日
塄	土四方
吁	口丁一
仉	亻几
湲	氵爪一𠂇又
祓	示犬㇕
刳	大一丂刂
犒	牛亠口冂口
秕	禾匕匕
炘	火斤
喁	口日冂厶
稞	禾田木
悒	心口巴
忑	下心
瓘	王艹口口隹
黟	四土火夕夕
娩	女召儿
搠	扌䒑屮月
枵	木口丂
螈	虫厂白小
睥	目鬼十
臬	自木
沚	氵止
靺	革一木
屺	山巳
迮	之𠂉匕
挲	氵小丿手
祆	示一大
茌	艹亻士
栝	木舌
螃	虫亠八冖方
墁	土日四又
鞨	革日勹亡
麈	鹿丶王
禊	示丰刀大
趔	走一夕刂
玡	王牙
掊	扌立口
蟋	虫釆心
毳	毛毛毛
訇	勹言
埴	土十目
搐	扌亠幺田
黻	业巾⺍犬㇕
廨	广𠂊用刀牛
瘳	疒习习人彡
孥	女又子
埤	土鬼十
呣	口母
籀	竹扌卯田
媵	月半女
揄	扌亼月刂
萏	艹𠂊臼
躇	足艹耂
儡	亻田田田
圬	土一丂
搛	扌禾禾彐
楯	木𠂆十目
痦	疒二乂口
樨	木尸水牛
巉	山召匕匕召儿丶
貅	豸亻木
怍	心𠂉匕
悛	心厶八夂
亏	一丂
蒴	艹䒑屮月
瞢	艹四冖目
雱	雨方
啁	口用口
艟	舟立田土
怩	心尸匕
澉	氵㇕耳攵
牂	爿羊
垧	土宀口
砒	石匕匕
澌	氵甘廾斤
綮	户攵糸
趄	走且
潸	氵木木月
霪	雨氵爪丿士
怫	心弓刂
褙	衤北月
耋	耂匕至
珧	王儿⺍
蕺	艹口耳戈
慝	匚艹𠂇口心
牾	牛二乂口
侉	亻大一丂
燠	火宀米大
殪	一夕士冖一口䒑
葸	艹田心
蓊	艹八厶习习
柈	木半
划	戈刂
匜	匚也
袤	衣予丿
礴	石艹氵甫寸
屣	尸行止止
酤	酉十口
躅	足四勹虫
肄	匕矢彐キ
癔	疒立日心
睚	目厂土土
瘙	疒又丶虫
忪	心八厶
娠	女辰
棼	木木八刀
蜴	虫日勿
裒	衣臼
癃	疒阝夂一生
蝙	虫户冊
戥	日生戈
襻	衤乂乂木木大手
褫	衤𠂆虎
搦	扌弓冫弓冫
漭	氵艹犬廾
耱	耒广木木石
攮	扌一中冖口口甘衤
羑	羊𠂊丶
怏	心冂大
捭	扌鬼十
蜮	虫戈口一
蜢	虫子皿
棻	艹八刀木
秭	禾丿乚亻
瘼	疒艹日大
褓	衤亻口木
垤	土至
鏖	鹿金
潲	氵禾小月
玕	王干
囫	圍勿
罽	四厂火火刂
牤	牛亡
黧	禾丿刀四土火
孳	䒑幺幺子
襁	衤弓口虫
腠	月丰一大
腧	月亼月刂
瘰	疒田糸
摽	扌西示
眈	目冖儿
膂	方𠂉亻月
妯	女由
篥	竹西木
螽	夂冫虫虫
爝	火爪四艮寸
劓	自田廾刂
膻	月亠圍口日一
胼	月䒑廾
羼	尸羊羊羊
齁	自田廾勹口
褊	衤户冊
蒹	艹禾禾彐
貔	豸囟匕匕
痼	疒圍十口
礅	石亠口子攵
郿	尸目阝
捃	扌尹口
芼	艹毛
梏	木牛口
忐	上心
麇	鹿禾
郛	爪子阝
蝣	虫方𠂉子
狨	犭戈𠂇
瀣	氵卜夕又非一
磙	石衣八厶
掮	扌户月
睃	目厶八夂
郫	鬼十阝
獴	犭艹冖一豕
瘵	疒䏑又示
藠	艹白白白
瘐	疒臼人
桕	木臼
篌	竹亻コ矢
狁	犭厶儿
躞	足言火火又
捽	扌亠人人十
猹	犭木日一
啕	口勹午凵
稃	禾爪子
縠	士冖一糸殳
蜊	虫禾刂
嵎	山日冂厶
惝	心小冂口
溽	氵辰寸
蜉	虫爪子
噍	口隹火
盉	禾皿
猁	犭禾刂
坫	土卜口
茀	艹弓刂
脬	月爪子
舢	舟山
祾	示土八夂
鬏	長彡禾火
忭	心亠卜
杻	木彐丨
唼	口立女
溘	氵土厶皿
桫	木氵小丿
黢	四土火厶八夂
蹁	足户冊
檗	尸口辛木
瞀	予丿攵目
鞡	革扌立
莅	艹亻立
瘊	疒亻コ矢
潟	氵臼勹火
抃	扌亠卜
猢	犭十口月
踺	足廴彐キ
眙	目厶口
嘚	口行日一寸
戽	户冫十
豇	一口䒑工
蹀	足廿乚木
牮	亻弋牛
燹	豕豕火
攉	扌雨隹
踽	足丿口冂厶
坏	土不
撙	扌八酉寸
蒺	艹疒矢
够	勹口夕夕
恓	心西
圣	又土
蒟	艹立勹口
跐	足止匕
歃	千臼欠
筲	竹小月
璈	王丰力攵
醐	酉十口月
蜍	虫亼木
稂	禾丶艮
殍	一夕爪子
箢	竹宀夕卩
鼢	臼釆八刀
蝥	予丿攵虫
蒡	艹亠八冖方
毪	毛厶牛
磲	石氵匚コ木
踟	足矢口
劁	隹火刂
靸	革𠂊又
蟥	虫廿由八
糨	米弓口虫
嚆	口艹亠口冂口
眊	目毛
眵	目夕夕
揠	扌匚日女
狳	犭亼木
猞	犭亼十口
髫	長彡召
蝻	虫十冂半
熥	火之龴用
璪	王口口口木
荸	艹十冖子
螵	虫西示
趑	走冫欠
鞬	革廴彐キ
玭	王匕匕
漶	氵中中心
躐	足巛圍乂巛
礓	石三田田
筢	竹扌巴
犄	牛大丁口
耥	耒小冂口
栟	木䒑廾
椪	木立立
耖	耒小丿
蝓	虫亼月刂
犋	牛目廾
搋	扌𠂆虎
靰	革兀
牦	牛毛
犰	犭九
觫	𠂊用木口
睾	丿四土半
毹	亼月刂毛
蜣	虫羊儿
熜	火囟夂心
氍	目目隹毛
聱	丰力攵耳
糌	米夂卜日
耠	耒亼口
弃	亠厶廾
极	木𠂊又
狺	犭言
瘃	疒豕
堉	土亠厶月
螬	虫一曲日
螠	虫䒑八皿
魆	鬼戈乚
葱	艹勿丶心
犏	牛户冊
睄	目小月
丏	丁乚㇕
靿	革幺力
碡	石丰母
揳	扌丰刀大
滫	氵亻丨攵月
霨	雨尸示寸
螋	虫臼丨又
唣	口白七
猫	犭艹田
琫	王丰キ
猪	犭耂
册	冊
拤	扌上卜
齉	自田廾一中冖口口甘衤
氆	毛立立日
鞧	革八酉
机	木几
隶	尹⺍
膙	月弓口虫
踒	足禾女
垒	厶厶厶土
号	口丂
扑	扌卜
汆	人水
赶	走干
窑	穴午凵
听	口斤
柠	木宀丁
猬	犭田月
猎	犭廿日
疴	疒丁口
凄	冫一尹女
疱	疒勹巳
椁	木亠口子
晋	一业日
眦	目止匕
亘	二日
痴	疒矢口
叙	亼木又
离	亠乂凵冂厶
虱	乙丿虫
滚	氵衣八厶
昵	日尸匕
屉	尸廿乚
无	一尤
与	一乚一
样	木羊
国	圍王丶
吨	口一屮
户	户
巩	工凡
却	土厶卩
担	扌日一
撑	扌小冖口手
携	扌隹㇕丿
抬	扌厶口
栀	扌𠂆一卩
构	木勹厶
医	匚矢
蝎	虫日勹亡
虮	虫几
咏	口丶水
踪	足宀示
叹	口又
网	冂乂乂
冈	冂乂
岭	山亼龴
复	𠂉日夂
笋	竹尹
偬	亻勿丶心
众	人人人
脚	月土厶卩
胆	月日一
庄	广土
凉	冫亠口小
决	冫㇕大
恒	心二日
潜	氵夫夫日
汹	氵乂凵
袜	衤一木
宫	宀口口
幂	冖日大巾
异	巳廾
苁	艹人人
栅	木冊
虬	虫乚
吕	口口
咤	口宀丿七
秆	禾干
鼹	臼釆日宀女
隽	隹㇕丿
腭	月口口一丂
删	冊刂
胶	月亠八乂
籼	米山
泞	氵宀丁
姗	女冊
扰	扌尤
芜	艹一尤
芦	艹户
碱	石戊一口
奋	大田
厩	厂艮旡
邮	由阝
毁	臼工殳
体	亻木一
优	亻尤
犹	犭尤
肮	月亠几
凑	冫丰一大
痒	疒羊
烛	火虫
怜	心亼龴
惊	心亠口小
羡	羊冫欠
洁	氵士口
垦	艮土
篱	竹亠乂凵冂厶
灯	火丁
橱	木厂一口䒑寸
减	冫戊一口
耻	耳止
忾	心气
厨	厂一口䒑寸
蹰	足厂一口䒑寸
凛	冫亠圍口示
欸	厶矢欠
厦	厂頁夂
厮	厂甘廾斤
亲	立木
届	尸由
珐	王土厶
厢	厂木目
籴	人米
忧	心尤
禀	亠圍口示
叠	又又又冖且
俵	亻丰衤
开	一廾
录	彐水
献	十冂半犬
园	圍一兀
杀	乂木
寻	彐寸
邓	又阝
吓	口下
沨	氵風
嘡	口小冖口土
触	𠂊用虫
媭	彡頁女
拃	扌𠂉匕
蹾	足亠口子攵
权	木又
杂	九木
丽	一冂丶冂丶
币	丿巾
仅	亻又
沟	氵勹厶
灵	彐火
箓	竹彐水
浕	氵尸丶冫
茧	艹虫
怀	心不
塆	土大八弓
蹽	足一火日小
茓	艹穴
柽	木又土
昙	日二厶
积	禾口八
敌	舌攵
块	土㇕大
备	夂田
关	䒑大
忏	心千
队	阝人
㧐	扌又又
䏝	月キ龴
㤘	心𠂊彐
宪	宀牛儿
现	王見
个	竹
说	言八口儿
为	爲
没	氵殳
这	之文
对	又寸
发	乚丿又丶
两	一冂人人
项	工頁
专	キ龴
来	木䒑
动	二厶力
长	長
联	耳䒑大
帮	丰阝巾
热	扌丸火
拨	扌乚丿又丶
带	艹丨冖巾
节	艹卩
标	木示
横	木廿由八
龙	龍
页	頁
顾	厂卩頁
车	車
区	匚乂
暂	車斤日
轨	車九
软	車欠
点	卜口火
旧	丨日
齿	齒
别	口力刂
员	口貝
吗	口馬
时	日寸
业	业
当	小彐
电	申
贱	貝一戈
败	貝攵
内	冂人
贩	貝𠂆又
见	見
赔	貝立口
县	且厶
税	禾八口儿
气	气
传	亻キ龴
顺	川頁
们	亻門
伪	亻爲
会	人二厶
领	亼龴頁
从	人人
镇	金十目廾
须	彡頁
钱	金一戈
钻	金卜口
钢	金冂乂
铁	金手丶
铬	金夂口
胀	月長
腻	月弋二貝
独	犭虫
肿	月中
风	風
脱	月八口儿
鱼	魚
条	夂木
乐	𠂆木
争	𠂊尹
鸟	鳥
讲	言二刂
让	言上
调	言用口
齐	齊
诉	言斤丶
设	言殳
该	言亠凵人
变	大八又
装	爿士衣
闻	門耳
闭	門十丿
问	門口
间	門日
门	門
将	爿夕寸
应	广⺍一
疗	疒了
废	广乚丿又丶
类	米大
炼	火七㇕八
总	八口心
单	八甲一
粮	米丶艮
数	婁攵
洒	氵西
滤	氵虎心
测	氵貝刂
学	⺍冖子
汉	氵又
泼	氵乚丿又丶
宽	宀艹見
军	冖車
补	衤卜
审	宀申
实	宀冫大
马	馬
层	尸二厶
颇	皮頁
观	又見
难	又隹
验	馬亼⺍一
买	㇕冫大
骗	馬户冊
张	弓長
阳	阝日
费	弓刂貝
办	力八
阴	阝月
习	习
弹	弓八甲一
随	阝之𠂇月
红	糸工
续	糸十㇕冫大
纯	糸一屮
细	糸田
组	糸且
统	糸亠厶儿
断	米乚斤
编	糸户冊
经	糸㇕丶工
顸	干頁
蚕	一大虫
顶	丁頁
鹉	戈止鳥
垩	亞土
严	一业丿
亚	亞
恶	亞心
画	一田凵
残	一夕一戈
殒	一夕口貝
歼	一夕千
殓	一夕亼⺍一
殁	一夕殳
殡	一夕宀斤廾
灭	一火
虿	一力虫
迈	之一力
坛	土二厶
墙	土十䒑圍口
盐	土卜皿
韦	㐄
颉	士口頁
埘	土日寸
坝	土貝
趱	走牛儿牛儿貝
进	之二刂
辇	夫夫車
规	夫見
赵	走乂
顽	一兀頁
远	之一兀
趋	走𠂊彐
坟	土文
圹	土广
颊	大䒑頁
夹	大䒑
郏	大䒑阝
壶	士冖业
壳	士冖几
声	士尸
韫	㐄日皿
场	土㇕勿
韬	㐄爪臼
运	之二厶
玮	王㐄
寿	丰寸
焘	丰寸火
耢	耒艹冖力
环	王不
珑	王龍
顼	王頁
琏	王之車
职	耳口八
璎	王貝貝女
责	丰貝
瑶	王爪午凵
玑	王几
靓	丰月見
静	丰月𠂊尹
麸	丰夂夫
艳	丰𠂊巴
聪	耳八口心
耧	耒婁
鬓	長彡宀斤廾
玛	王馬
聂	耳又又
抚	扌一尤
挟	扌大䒑
摄	扌耳又又
挝	扌之寸
捞	扌艹冖力
拢	扌龍
挞	扌之大
拣	扌七㇕八
抠	扌匚乂
摅	扌虎心
损	扌口貝
挡	扌小彐
摆	扌四土厶
拥	扌用
攒	扌牛儿牛儿貝
捡	扌亼⺍一
抡	扌人匕
抢	扌人卩
摇	扌爪午凵
垫	扌丸土
蛰	扌丸虫
挚	扌丸手
执	扌丸
抛	扌九力
撸	扌魚日
换	扌𠂊冂大
搀	扌召儿冫
挣	扌𠂊尹
挤	扌齊
过	之寸
扩	扌广
扪	扌門
搁	扌門夂口
掷	扌䒑大阝
搂	扌婁
㧟	扌氵匚
搅	扌⺍冖見
拧	扌宀丁
挥	扌冖車
撺	扌穴中中
护	扌户
摈	扌宀斤廾
扫	扌彐
摊	扌又隹
扬	扌㇕勿
报	扌卩又
掺	扌厶大彡
拟	扌厶人
荚	艹大䒑
苇	艹㐄
苌	艹長
协	十力八
鞯	革艹一亻子
蔷	艹十䒑圍口
茏	艹龍
载	十戈車
莲	艹之車
莴	艹咼
颧	艹口口隹頁
莳	艹日寸
蓝	艹刂𠂉丶皿
黄	廿由八
蓦	艹日大馬
苘	艹冂口
贳	廿乚貝
颠	十目廾頁
苋	艹見
荞	艹丿大刂
获	艹犭犬
茑	艹鳥
蔼	艹言日勹亡
蔺	艹門隹
蒋	艹爿夕寸
丧	土八衤
啬	十䒑圍口
蕲	艹八甲一斤
荡	艹氵㇕勿
苎	艹宀一
茔	艹冖土
莹	艹冖王丶
荣	艹冖木
荤	艹冖車
萤	艹冖虫
营	艹冖口口
荥	艹冖水
蓥	艹冖金
荧	艹冖火
劳	艹冖力
萦	艹冖糸
茎	艹㇕丶工
萧	艹尹川八
卖	十㇕冫大
艺	艹乙
荪	艹子小
苏	艹力八
荫	艹阝月
萨	艹阝立丿
蕴	艹糸日皿
药	艹糸勹丶
飘	西示風
枨	木長
樯	木十䒑圍口
栉	木艹卩
梦	木木夕
栊	木龍
雳	雨厂力
栋	木七小
栈	木一戈
枢	木匚乂
梿	木之車
档	木小彐
贾	西貝
枧	木見
枣	木冂冫
桥	木丿大刂
酰	酉牛儿
霉	雨𠂉母
检	木亼⺍一
枪	木人卩
枫	木風
橹	木魚日
赖	木口𠂊貝
霁	雨齊
术	木丶
酿	酉丶艮
桩	木广土
榈	木門口口
楼	木婁
槟	木宀斤廾
树	木又寸
棂	木彐火
椭	木阝𠂇月
杨	木㇕勿
厅	厂丁
厉	厂一力
压	厂土丶
硖	石大䒑
砖	石キ龴
夺	大寸
硕	石頁
厌	厂犬
砗	石車
奁	大匚乂
还	之不
碍	石日一寸
厕	厂貝刂
砚	石見
垄	龍土
砻	龍石
赝	厂亻隹貝
矶	石几
砜	石風
飙	犬犬犬風
袭	龍衣
态	大丶心
矿	石广
牵	大冖牛
码	石馬
历	厂力
础	石屮凵
轩	車干
辆	車一冂人人
辕	車土口衤
贰	弋二貝
转	車キ龴
辄	車耳乚
连	之車
轰	車又又
轧	車乚
辅	車甫
颐	臣頁
尧	戈兀
翘	戈兀习习
轾	車至
卧	臣卜
轳	車卜尸
辑	車口耳
匮	匚中一貝
轴	車由
东	七小
辊	車日匕匕
辋	車冂䒑亡
盏	一戈皿
轿	車丿大刂
输	車亼月刂
殴	匚乂殳
轮	車人匕
堑	車斤土
錾	車斤金
鸦	牙鳥
较	車亠八乂
辙	車亠厶月攵
辘	車鹿
辚	車米夕㐄
辖	車宀丰口
轻	車㇕丶工
辗	車尸廿衤
轫	車刀丶
顿	一屮頁
辎	車巛田
蛱	虫大䒑
龉	齒二乂口
螨	虫艹一冂人人
蛲	虫戈兀
龇	齒止匕
战	卜口戈
蝇	虫黽
蜗	虫咼
卤	卜圍乂
蛳	虫刂一巾
频	止癶頁
虚	虎业
蛊	虫皿
贞	卜貝
蚬	虫見
龄	齒亼龴
蜕	虫八口儿
蝉	虫八甲一
虑	虎心
蛏	虫又土
颅	卜尸頁
龌	齒尸至
卢	卜尸
蚂	虫馬
虏	虎力
吴	口一大
哑	口亞
贵	中一貝
围	圍㐄
踌	足丰寸
啧	口丰貝
唛	口丰夂
蹑	足耳又又
𠳐	口丰阝
团	圍十丿
蹒	足艹一冂人人
喷	口十艹貝
躏	足艹門隹
呓	口艹乙
咙	口龍
跷	足戈兀
践	足一戈
呕	口匚乂
嘘	口虎业
啮	口齒
虽	口虫
颚	口口一丂頁
圆	圍口貝
骂	口口馬
黾	黽
呗	口貝
啰	口四夕
郧	口貝阝
跃	足丿大
躜	足牛儿牛儿貝
响	口宀口
哗	口亻匕十
囵	圍人匕
呛	口人卩
嗳	口爪冖𠂇又
叽	口几
鹃	口月鳥
噜	口魚日
唤	口𠂊冂大
图	圍夂冫
鸣	口鳥
跻	足齊
踯	足䒑大阝
喽	口婁
咛	口宀丁
蹿	足穴中中
吣	口心
嘱	口尸丿口冂厶
啸	口尹川八
哟	口糸勹丶
题	日一止頁
师	刂一巾
韪	日一止㐄
畴	田丰寸
颗	田木頁
晒	日西
辉	小兀冖車
辈	非車
晓	日戈兀
鸭	甲鳥
显	日业
帅	刂巾
临	刂𠂉丶口丨
监	刂𠂉丶皿
览	刂𠂉丶見
鉴	刂𠂉丶金
尘	小土
暧	日爪冖𠂇又
旷	日广
邺	业阝
凿	业半凵
尝	小冖二厶
晕	日冖車
赏	小冖口貝
归	刂彐
贤	刂又貝
肾	刂又月
竖	刂又立
紧	刂又糸
畅	申㇕勿
赋	貝戈止
赇	貝十⺍丶
屿	山一乚一
峡	山大䒑
罢	四土厶
帐	巾長
账	貝長
帻	巾丰貝
财	貝十丿
瞒	目艹一冂人人
巅	山十目廾頁
嵘	山艹冖木
赎	貝十㇕冫大
赙	貝甫寸
颛	山而頁
眬	目龍
贿	貝𠂇月
鸯	冂大鳥
贼	貝戈𠂇
岖	山匚乂
崭	山車斤
贴	貝卜口
帧	巾卜貝
帜	巾口八
贶	貝口儿
刚	冂乂刂
赐	貝日勿
幞	巾业半大
岿	山刂彐
婴	貝貝女
峤	山丿大刂
贝	貝
赌	貝耂
则	貝刂
赂	貝夂口
岚	山風
岁	山夕
睁	目𠂊尹
购	貝勹厶
罚	四言刂
赃	貝广土
赠	貝八四日
赕	貝火火
赚	貝禾禾彐
髅	骨婁
贮	貝宀一
髋	骨宀艹見
髌	骨宀斤廾
峄	山又キ
瞩	目尸丿口冂厶
剀	山巳刂
觊	山巳見
凯	山巳几
岂	山巳
悬	且厶心
丢	丿土厶
筹	竹丰寸
穑	禾十䒑圍口
迁	之千
犊	牛十㇕冫大
笼	竹龍
乔	丿大刂
箧	竹匚大䒑
笺	竹一戈
毡	毛卜口
乱	舌乚
鹄	牛口鳥
篮	竹刂𠂉丶皿
笕	竹見
笔	竹毛
签	竹亼⺍一
秃	禾几
颓	禾几頁
称	禾竹八
赞	牛儿牛儿貝
选	之牛儿
稳	禾𠂊彐心
鹅	手戈鳥
辞	舌辛
简	竹門日
篓	竹婁
氢	气㇕丶工
箫	竹尹川八
笃	竹馬
笾	竹之力
俩	亻一冂人人
粤	宀米一丂
侠	亻大䒑
伟	亻㐄
伥	亻長
债	亻丰貝
偾	亻十艹貝
牍	爿十㇕冫大
侥	亻戈兀
贷	亻弋貝
舆	臼車廾
躯	身匚乂
侦	亻卜貝
俣	亻口一大
侣	亻口口
侧	亻貝刂
皑	白山巳
侨	亻丿大刂
赁	亻丿士貝
伤	亻𠂉力
俭	亻亼⺍一
伦	亻人匕
华	亻匕十
倾	亻匕頁
货	亻匕貝
储	亻言耂
侪	亻齊
奥	宀米大
鹪	隹火鳥
偻	亻婁
伫	亻宀一
傧	亻宀斤廾
侬	亻冖衤
傩	亻又隹
亿	亻乙
龛	亼口龍
剑	亼⺍一刂
敛	亼⺍一攵
刽	人二厶刂
饵	食耳
仓	人卩
馕	食一中冖口口甘衤
馍	食艹日大
馓	食廿月攵
饽	食十冖子
弑	乂木弋工
刹	乂木刂
饶	食戈兀
饯	食一戈
彻	行七刀
饨	食一屮
衔	行金
馈	食中一貝
馄	食日匕匕
饪	食丿士
饫	食丿大
饿	食手戈
饰	食𠂉巾
饬	食𠂉力
饷	食宀口
馊	食臼丨又
丛	人人一
耸	人人耳
怂	人人心
爷	八乂卩
饭	食𠂆又
馁	食爪女
饥	食几
馋	食召儿冫
馅	食𠂊臼
饮	食欠
仑	人匕
馏	食卯田
饱	食勹巳
颔	亼㇕口頁
贪	亼㇕貝
伞	人八十
饼	食䒑廾
馐	食羊彐丨
邻	亼龴阝
馆	食宀㠯
蚀	食虫
饲	食㇕一口
颁	八刀頁
戗	人卩戈
创	人卩刂
贫	八刀貝
饧	食㇕勿
颂	八厶頁
饴	食厶口
钉	金丁
铐	金耂丂
铼	金木䒑
锗	金耂
铑	金耂匕
铗	金大䒑
钍	金土
铸	金丰寸
铒	金耳
钰	金王丶
镊	金耳又又
钳	金甘
针	金十
钴	金十口
错	金廿日
质	𠂆十貝
镬	金艹隹又
钵	金木一
铺	金甫
镭	金雨田
锛	金大十艹
钚	金不
钛	金大丶
镣	金一火日小
钹	金犬㇕
铙	金戈兀
链	金之車
钺	金戈乚
钋	金卜
舻	舟卜尸
锃	金口王
铟	金圍大
锢	金圍十口
钟	金中
铝	金口口
锅	金咼
钽	金日一
锂	金田土
钊	金刂
锞	金田木
钿	金田
锁	金小貝
钞	金小丿
销	金小月
锡	金日勿
镗	金小冖口土
铛	金小彐
铜	金冂一口
盘	舟皿
钠	金冂人
钡	金貝
舰	舟見
钼	金目
锄	金且力
钎	金千
锇	金手戈
锆	金牛口
锸	金千臼
铣	金牛儿
锹	金禾火
锈	金禾㇕丿
锻	金厂三殳
钏	金川
镍	金自木
锥	金隹
铂	金白
锦	金白巾
镌	金隹㇕丿
铨	金人王
铩	金乂木
锉	金人人土
钤	金亼㇕
铃	金亼龴
舱	舟人卩
锨	金斤欠
钣	金𠂆又
钒	金凡
铅	金几口
钥	金月
锋	金夂丰
铭	金夕口
铆	金卯
钦	金欠
钓	金勹丶
钧	金勹冫
铮	金𠂊尹
钩	金勹厶
锌	金辛
镜	金立日儿
铈	金亠巾
铲	金立丿
铱	金衣
镑	金亠八冖方
锒	金丶艮
钫	金方
镀	金广廿又
镧	金門木四
锏	金門日
锵	金爿夕寸
镰	金广禾禾彐
镁	金羊大
锐	金八口儿
锑	金弋弓
镂	金婁
铫	金儿⺍
锭	金宀一止
爱	爪冖𠂇又
镩	金穴中中
铋	金弋八
镔	金宀斤廾
释	釆又キ
锯	金尸十口
铍	金皮
银	金艮
铌	金尸匕
钗	金又丶
锰	金子皿
钌	金了
键	金廴彐キ
铷	金女口
锱	金巛田
钕	金女
肤	月夫
狭	犭大䒑
胧	月龍
胨	月七小
胪	月卜尸
狈	犭貝
猡	犭四夕
犸	犭馬
脸	月亼⺍一
飓	風目廾
飕	風臼丨又
飑	風勹巳
鹏	月月鳥
狰	犭𠂊尹
鸠	九鳥
狱	犭言犬
脐	月齊
脑	月亠乂凵
脏	月广土
犷	犭广
腾	月半馬
狞	犭宀丁
膑	月宀斤廾
脓	月冖衤
胫	月㇕丶工
胁	月力八
猕	犭弓竹八
鲠	魚一日乂
鲡	魚一冂丶冂丶
鲆	魚干八
鲑	魚土土
鲮	魚土八夂
鳍	魚耂匕日
鲼	魚十艹貝
鲽	魚廿乚木
鸨	匕十鳥
鳓	魚革力
鳕	魚雨彐
顷	匕頁
鲔	魚𠂇月
鱿	魚尤
鳜	魚厂䒑屮欠
鲅	魚犬㇕
鲢	魚之車
处	夂卜
鲇	魚卜口
鲈	魚卜尸
鲴	魚圍十口
鲤	魚田土
鲱	魚非
鲳	魚日日
鳗	魚日四又
尔	竹八
鲲	魚日匕匕
鲁	魚日
迩	之竹八
鳃	魚田心
鲣	魚刂又土
鳎	魚日习习
龟	龜
鲷	魚用口
奂	𠂊冂大
鳏	魚四水
岛	鳥山
负	𠂊貝
觯	𠂊用八甲一
稣	魚禾
颖	匕禾頁
鳅	魚禾火
鲧	魚丿糸
鳇	魚白王
鲋	魚亻寸
鲵	魚臼儿
鳐	魚爪午凵
凫	鳥几
毕	匕匕十
鲍	魚勹巳
贸	卯貝
鲚	魚齊
鲂	魚方
鲜	魚羊
鳟	魚八酉寸
鳞	魚米夕㐄
鳝	魚羊䒑口
鲩	魚宀一兀
鳊	魚户冊
鸵	鳥宀匕
刍	𠂊彐
鲟	魚彐寸
雏	𠂊彐隹
皱	𠂊彐皮
邹	𠂊彐阝
鲫	魚艮卩
务	夂力
鸳	夕卩鳥
匀	勹冫
乌	烏
枭	鳥木
鲐	魚厶口
订	言丁
诃	言丁口
评	言干八
诖	言土土
诗	言土寸
讧	言工
诘	言士口
诸	言耂
诬	言工人人
语	言二乂口
讳	言㐄
诔	言耒
请	言丰月
诹	言耳又
亵	衣扌丸
讨	言寸
计	言十
谋	言甘木
谍	言廿乚木
诺	言艹𠂇口
诂	言十口
谳	言十冂半犬
谎	言艹亡川
读	言十㇕冫大
谌	言甘匚八
谭	言西日十
谏	言木四
斋	文而
诼	言豕
诙	言𠂇火
试	言弋工
诓	言匚王
诫	言戈廾
讶	言牙
讴	言匚乂
谮	言旡旡日
诚	言戊㇕
讵	言匚コ
讣	言卜
谑	言虎匚一
误	言口一大
颤	亠圍口日一頁
识	言口八
赢	亡口月貝凡
诽	言非
刘	文刂
栾	大八木
课	言田木
亩	亠田
蛮	大八虫
谩	言日四又
谡	言田八夂
銮	大八金
诮	言小月
谓	言田月
弯	大八弓
诅	言且
讪	言山
讷	言冂人
挛	大八手
许	言午
话	言舌
诰	言牛口
诛	言𠂉木
颜	立丿彡頁
诱	言禾㇕丿
诲	言𠂉母
训	言川
谁	言隹
剂	齊刂
谯	言隹火
谕	言亼月刂
诠	言人王
认	言人
谶	言人人戈非一
诊	言人彡
论	言人匕
义	丶乂
诟	言𠂆一口
谣	言爪午凵
诳	言犭王
讥	言几
颃	亠几頁
讽	言風
诡	言𠂊厂卩
谗	言召儿冫
询	言勹日
诣	言匕日
谄	言𠂊臼
谐	言匕匕白
诋	言氏丶
诌	言𠂊彐
鸾	大八鳥
谅	言亠口小
谙	言立日
谚	言立丿彡
议	言丶乂
辩	辛言辛
谛	言亠八冖巾
谤	言亠八冖方
访	言方
斓	文門木四
详	言羊
产	立丿
谥	言䒑八皿
谈	言火火
谜	言之米
谦	言禾禾彐
诨	言冖車
谴	言之中一㠯
谊	言宀且
诧	言宀丿七
译	言又キ
诀	言㇕大
诵	言龴用
词	言㇕一口
讯	言乙十
诏	言召
诞	言廴丿止
记	言巳
诒	言厶口
娈	大八女
颏	亠凵人頁
辫	辛糸辛
庑	广一尤
疠	疒一力
闺	門土土
冯	冫馬
痨	疒艹冖力
癞	疒木口𠂊貝
阑	門木四
鹇	門木鳥
头	冫大
庆	广大
库	广車
阉	門大申
庞	广龍
状	爿犬
邝	广阝
阈	門戈口一
冻	冫七小
壮	爿士
阃	門圍木
闸	門甲
阊	門日日
闩	門一
闰	門王
痈	疒用
闲	門木
闽	門虫
訚	門言
闯	門馬
阀	門亻戈
鹰	疒亻隹鳥
瘪	疒自人匕
阋	門臼儿
闪	門人
疮	疒人卩
疯	疒風
桨	爿夕木
奖	爿夕大
浆	爿夕水
资	冫欠貝
阎	門𠂊臼
癣	疒魚羊
净	冫𠂊尹
闹	門亠巾
阂	門亠凵人
痫	疒門木
阅	門八口儿
阐	門八甲一
瘘	疒婁
阔	門氵舌
闼	門之大
庐	广户
闷	門心
阕	門癶一大
阚	門㇕耳攵
瘫	疒又隹
疡	疒㇕勿
瘾	疒阝𠂊彐心
疖	疒卩
妆	爿女
兰	䒑二
鲞	半魚
誊	半言
怅	心長
慑	心耳又又
愤	心十艹貝
懒	心木口𠂊貝
娄	婁
恹	心厂犬
烦	火頁
郑	䒑大阝
烧	火戈兀
怄	心匚乂
惭	心車斤
兑	八口儿
兽	八田一口
悭	心刂又土
灿	火山
惧	心目廾
恺	心山巳
养	羊刂
烨	火亻匕十
烃	火㇕丶工
烁	火𠂆木
焕	火𠂊冂大
恼	心亠乂凵
悯	心門文
焖	火門心
悦	心八口儿
惮	心八甲一
恽	心冖車
烬	火尸丶冫
忆	心乙
炀	火㇕勿
鹈	弋弓鳥
递	之弋弓
惨	心厶大彡
惯	心母貝
兹	䒑幺幺
举	⺍廾キ
兴	⺍廾
誉	⺍廾言
洼	氵土土
鸿	氵工鳥
浃	氵大䒑
涛	氵丰寸
沣	氵丰
渍	氵丰貝
滟	氵丰𠂊巴
满	氵艹一冂人人
滞	氵艹丨冖巾
潇	氵艹尹川八
泷	氵龍
沥	氵厂力
浇	氵戈兀
浅	氵一戈
沤	氵匚乂
渐	氵車斤
汇	氵匚
涟	氵之車
浊	氵虫
泸	氵卜尸
涠	氵圍㐄
渑	氵黽
涡	氵咼
湿	氵日业
温	氵日皿
溅	氵貝一戈
滗	氵竹毛
渊	氵川米
潋	氵亼⺍一攵
沦	氵人匕
潴	氵犭耂
涤	氵夂木
涣	氵𠂊冂大
渔	氵魚
滦	氵大八木
润	氵門王
澜	氵門木四
涧	氵門日
沩	氵爲
浑	氵冖車
觉	⺍冖見
沪	氵户
滨	氵宀斤廾
浓	氵冖衤
泽	氵又キ
浔	氵彐寸
滩	氵又隹
涨	氵弓長
汤	氵㇕勿
涩	氵刀丶止
烫	氵㇕勿火
渗	氵厶大彡
潍	氵糸隹
逦	之一冂丶冂丶
写	冖一乚一
窍	穴工丂
窥	穴夫見
违	之㐄
祷	示丰寸
宝	宀王丶
赛	宀甘八貝
骞	宀甘八馬
宠	宀龍
窃	穴七刀
祯	示卜貝
遗	之中一貝
祸	示咼
褴	衤刂𠂉丶皿
裆	衤小彐
视	示見
袄	衤丿大
鹤	冖隹鳥
穷	穴力
遥	之爪午凵
宾	宀斤廾
额	宀夂口頁
农	冖衤
礼	示乚
裤	衤广車
禅	示八甲一
迟	之尸丶
逊	之子小
边	之力
辽	之了
骊	馬一冂丶冂丶
颈	㇕丶工頁
巯	㇕丶工亠厶川
劲	㇕丶工力
骤	馬耳又亻
怼	又寸心
骐	馬甘廾
剧	尸十口刂
骑	馬大丁口
驮	馬大
戏	又戈
驱	馬匚乂
驶	馬口乂
骒	馬田木
剥	彐水刂
骡	馬田糸
驷	馬四
骄	馬丿大刂
属	尸丿口冂厶
驯	馬川
骓	馬隹
肃	尹川八
骅	馬亻匕十
骢	馬囟夂心
驳	馬乂乂
屦	尸行婁
驹	馬勹口
骆	馬夂口
欢	又欠
骝	馬卯田
鸡	又鳥
驻	馬丶王
骧	馬衣口口甘
昼	尸丶日一
尽	尸丶冫
骇	馬亠凵人
骥	馬北田艹廾
骈	馬䒑廾
屡	尸婁
驴	馬户
驼	馬宀匕
骟	馬户习习
恳	艮心
驿	馬又キ
预	予頁
艰	又艮
驭	馬又
骣	馬尸子子子
驰	馬也
劝	又力
骖	馬厶大彡
骀	馬厶口
骏	馬厶八夂
卫	卩一
际	阝示
陕	阝大䒑
陆	阝キ凵
陇	阝龍
阵	阝車
陈	阝七小
贺	力口貝
驾	力口馬
孙	子小
坠	阝人土
阶	阝亻八
弥	弓竹八
隐	阝𠂊彐心
飞	乙冫
导	巳寸
纡	糸丁一
妩	女一尤
娅	女亞
结	糸士口
绪	糸耂
绫	糸土八夂
纬	糸㐄
纭	糸二厶
绩	糸丰貝
绑	糸丰阝
纣	糸寸
绀	糸甘
缂	糸革
绁	糸廿乚
缚	糸甫寸
缃	糸木目
绔	糸大一丂
叁	厶大三
缛	糸辰寸
缅	糸頁圍
参	厶大彡
缄	糸戊一口
绕	糸戈兀
线	糸一戈
妪	女匚乂
练	糸七㇕八
绰	糸卜日十
娱	女口一大
缉	糸口耳
绳	糸黽
娲	女咼
织	糸口八
绢	糸口月
绯	糸非
缦	糸日四又
纱	糸小丿
绡	糸小月
缇	糸日一止
缧	糸田糸
绸	糸用口
纲	糸冂乂
缨	糸貝貝女
纳	糸冂人
纴	糸丿士
纤	糸千
缵	糸牛儿牛儿貝
妫	女爲
妈	女馬
绣	糸禾㇕丿
缎	糸厂三殳
维	糸隹
绵	糸白巾
缴	糸白方攵
给	糸亼口
绘	糸人二厶
绗	糸行
纵	糸人人
纶	糸人匕
纷	糸八刀
缓	糸爪一𠂇又
绥	糸爪女
绷	糸月月
纨	糸丸
绦	糸夂木
纸	糸氏
绺	糸夂卜口
络	糸夂口
绚	糸勹日
约	糸勹丶
终	糸夂冫
绉	糸𠂊彐
绝	糸𠂊巴
纹	糸文
纺	糸方
娴	女門木
缠	糸广田土
绊	糸半
婵	女八甲一
缯	糸八四日
缮	糸羊䒑口
继	糸米乚
综	糸宀示
绽	糸宀一止
婶	女宀申
缩	糸宀亻一白
缝	糸之夂丰
绾	糸宀㠯
妇	女彐
纽	糸彐丨
绿	糸彐水
纾	糸予
绍	糸召
贯	母貝
级	糸𠂊又
纫	糸刀丶
纪	糸巳
丝	糸糸
缘	糸彑豕
纠	糸凵
缫	糸巛田木
乡	乚凵
飨	乚凵食
戬	一业日戈
鹂	一冂丶冂丶鳥
郦	一冂丶冂丶阝
殚	一夕八甲一
殇	一夕𠂉㇕勿
趸	一力足
劢	一力力
欤	一乚一欠
垭	土亞
叆	二厶爪冖𠂇又
赉	木䒑貝
鼋	一兀黽
埯	土大申
贡	工貝
觋	工人人見
垆	土卜尸
韧	㐄刀丶
击	キ凵
埙	土口貝
埚	土咼
垱	土小彐
坞	土烏
毂	士冖車殳
悫	士冖几心
玙	王一乚一
聩	耳中一貝
颞	耳又又頁
赘	丰力攵貝
鳌	丰力攵魚
骜	丰力攵馬
麦	丰夂
琐	王小貝
珰	王小彐
瓒	王牛儿牛儿貝
琼	王亠口小
珲	王冖車
撷	扌士口頁
撵	扌夫夫車
抟	扌キ龴
挠	扌戈兀
掳	扌虎力
掴	扌圍王丶
揽	扌刂𠂉丶見
撄	扌貝貝女
揿	扌金欠
贽	扌丸貝
鸷	扌丸鳥
势	扌丸力
捣	扌鳥山
拦	扌䒑二
掸	扌八甲一
擞	扌婁攵
择	扌又キ
挦	扌彐寸
掼	扌母貝
觐	廿口丰見
荆	艹一廾刂
鹊	廿日鳥
颟	艹一冂人人頁
觏	甘冂土見
莱	艹木䒑
韩	十日十㐄
贲	十艹貝
鸪	十口鳥
鹕	十口月鳥
赍	十人人冖貝
鹁	十冖子鳥
鞒	革丿大刂
鞑	革之大
鞲	革甘冂土
苈	艹厂力
鹳	艹口口隹鳥
鹋	艹田鳥
萝	艹四夕
蘖	艹丿㠯辛木
荟	艹人二厶
苍	艹人卩
莸	艹犭尤
蓟	艹魚刂
荜	艹匕匕十
藓	艹魚羊
蓠	艹亠乂凵冂厶
荠	艹齊
蒌	艹婁
薮	艹婁攵
荦	艹冖牛
莺	艹冖鳥
茕	艹冖乙十
荨	艹彐寸
荩	艹尸丶冫
荬	艹㇕冫大
荮	艹糸寸
莼	艹糸一屮
芗	艹乚凵
酝	酉二厶
酽	酉一业丿
椟	木十㇕冫大
枥	木厂力
桡	木戈兀
桢	木卜貝
栌	木卜尸
榄	木刂𠂉丶見
槛	木刂𠂉丶皿
樱	木貝貝女
椤	木四夕
桤	木山巳
桦	木亻匕十
桧	木人二厶
枞	木人人
栎	木𠂆木
槠	木言耂
檩	木亠圍口示
栏	木䒑二
棁	木八口儿
霭	雨言日勹亡
榉	木⺍廾キ
雾	雨夂力
橼	木糸彑豕
碛	石丰貝
鹩	一火日小鳥
鹌	大申鳥
砺	石厂一力
厍	厂車
靥	厂犬頁圍
魇	厂犬鬼
餍	厂犬食
励	厂一力力
硗	石戈兀
鸸	而鳥
聋	龍耳
龚	龍艹廾
矾	石凡
砾	石𠂆木
尴	尤刂𠂉丶皿
砀	石㇕勿
碜	石厶大彡
赜	臣丰貝
鸫	七小鳥
辏	車丰一大
轲	車丁口
轱	車十口
轭	車厂卩
轼	車弋工
辐	車一口田
轶	車手丶
轸	車人彡
斩	車斤
椠	車斤木
辂	車夂口
辍	車又又又又
匦	匚車九
欧	匚乂欠
鸥	匚乂鳥
瓯	匚乂瓦
鸢	弋鳥
虾	虫下
觇	卜口見
鸬	卜尸鳥
蝾	虫艹冖木
蛎	虫厂一力
觑	虎业見
颦	止癶頁鬼十
蝈	虫圍王丶
龋	齒丿口冂厶
龊	齒足
龃	齒且
龀	齒匕
龅	齒勹巳
龈	齒艮
蛴	虫齊
蚁	虫丶乂
蝼	虫婁
呒	口一尤
鸮	口丂鳥
嗫	口耳又又
唠	口艹冖力
呖	口厂力
哓	口戈兀
啭	口車キ龴
踬	足𠂆十貝
跶	足之大
鹭	足夂口鳥
跹	足之千
跄	足人卩
跸	足匕匕十
跞	足𠂆木
嚣	口口頁口口
鼍	口口田一黽
鹗	口口一丂鳥
唢	口小貝
嘤	口貝貝女
呐	口冂人
剐	咼刂
哕	口山夕
勋	口貝力
哙	口人二厶
哔	口匕匕十
呜	口烏
哝	口冖衤
咝	口糸
坚	刂又土
颙	日冂厶頁
颢	日亠口小頁
鳖	巾⺍攵魚
旸	日㇕勿
睐	目木䒑
眍	目匚乂
帏	巾㐄
帼	巾圍王丶
羁	四革馬
黪	四土火厶大彡
鹮	四一口衤鳥
罗	四夕
逻	之四夕
黩	四土火十㇕冫大
罴	四土厶火
崃	山木䒑
峣	山戈兀
岗	山冂乂
岘	山見
刿	山夕刂
峥	山𠂊尹
嵝	山婁
崂	山艹冖力
睑	目亼⺍一
罂	貝貝午凵
赈	貝辰
贬	貝丿之
赊	貝人示
赡	貝𠂊厂八言
贻	貝厶口
赅	貝亠凵人
鹦	貝貝女鳥
䁖	目婁
鹘	骨鳥
矫	矢丿大刂
牺	牛西
箦	竹丰貝
秽	禾山夕
籁	竹木口𠂊貝
秾	禾冖衤
氇	毛魚日
鸹	舌鳥
篑	竹中一貝
筛	竹刂一巾
箩	竹四夕
衅	丿皿半
筚	竹匕匕十
筝	竹𠂊尹
箪	竹八甲一
簖	竹米乚斤
氩	气亞
氲	气日皿
俨	亻一业丿
俪	亻一冂丶冂丶
俦	亻丰寸
伛	亻匚乂
雠	隹言隹
魉	鬼一冂人人
囱	囟夂
偿	亻小冖二厶
傥	亻小冖口儿
侩	亻人二厶
伧	亻人卩
仪	亻丶乂
佥	亼⺍一
颌	亼口頁
鸽	亼口鳥
觎	亼月刂見
徕	行木䒑
惩	行一止心
鸻	行鳥
径	行㇕丶工
鹆	八人口鳥
饸	食亼口
馔	食巳巳艹廾
馑	食廿口丰
馇	食木日一
馃	食田木
馒	食日四又
饩	食气
饺	食亠八乂
饹	食夂口
钲	金一止
钙	金下乚
镉	金一口冂八丁
铻	金二乂口
锲	金丰刀大
颀	斤頁
䦃	金艹耂
锚	金艹田
镖	金西示
镡	金西日十
锜	金大丁口
镢	金厂䒑屮欠
钝	金一屮
锷	金口口一丂
锝	金日一寸
铀	金由
钾	金甲
镘	金日四又
锟	金日匕匕
锶	金田心
铿	金刂又土
铡	金貝刂
镚	金山月月
镯	金四勹虫
锣	金四夕
铠	金山巳
铤	金廴亻土
锤	金千艹二
铢	金𠂉木
铧	金亻匕十
铪	金亼口
铄	金𠂆木
锴	金匕匕白
镵	金召匕匕召儿丶
铯	金𠂊巴
镏	金卯田
钨	金烏
镶	金衣口口甘
镐	金亠口冂口
镞	金方𠂉矢
铰	金亠八乂
镝	金亠八冂十口
镦	金亠口子攵
铳	金亠厶儿
铉	金亠幺
镳	金鹿火
镛	金广尹用
镒	金䒑八皿
锩	金半卩
觅	爪見
鹞	金午凵鳥
镓	金宀豕
镲	金宀䏑又示
铊	金宀匕
铵	金宀女
铎	金又キ
钮	金彐丨
镫	金癶一口䒑
锔	金尸㇕口
锕	金阝丁口
钇	金乙
钯	金巴
镪	金弓口虫
镠	金习习人彡
镴	金巛圍乂巛
䥽	金乚丿又丶
凤	几又
腼	月頁圍
狮	犭刂一巾
猃	犭亼⺍一
狯	犭人二厶
獭	犭木口𠂊貝
臜	月牛儿牛儿貝
狲	犭子小
脍	月人二厶
肠	月㇕勿
鳔	魚西示
鸱	氏丶鳥
鲀	魚一屮
鳄	魚口口一丂
鳀	魚日一止
玺	竹八王丶
鲥	魚日寸
鳢	魚曲一口䒑
觞	𠂊用𠂉㇕勿
鹐	𠂊臼鳥
颍	匕水頁
毙	匕匕一夕匕
颎	匕火頁
鲸	魚亠口小
惫	夂田心
鲛	魚亠八乂
鳙	魚广尹用
鸲	勹口鳥
邬	烏阝
鲻	魚巛田
袅	鳥衣
讦	言干
证	言一止
谨	言廿口丰
谟	言艹日大
谔	言口口一丂
鹫	亠口小尤鳥
鹑	亠口子鳥
谠	言小冖口儿
峦	大八山
脔	大八䏑
谒	言日勹亡
恋	大八心
孪	大八子
诈	言𠂉匕
诜	言牛儿
讫	言𠂉乙
诿	言禾女
谢	言身寸
谀	言臼人
讹	言亻匕
赟	文戈止貝
齑	齊非一
谂	言亼㇕心
兖	亠八厶儿
衮	衣八厶
讼	言八厶
谖	言爪一𠂇又
谵	言𠂊厂八言
诤	言𠂊尹
谆	言亠口子
谇	言亠人人十
谪	言亠八冂十口
谰	言門木四
赣	立日十夂工貝
竞	立口儿
谱	言立立日
戆	立日十夂工貝心
彦	立丿彡
飒	立風
谝	言户冊
谧	言弋八皿
谲	言予丿冂八口
谬	言习习人彡
诩	言习习
盗	冫欠皿
癫	疒十目廾頁
廪	广亠圍口示
庙	广由
麽	广木木丿厶
赓	广彐人貝
鹧	广廿火鳥
疬	疒厂力
疟	疒匚一
酱	爿夕酉
阇	門耂
闱	門㐄
阒	門目犬
闳	門𠂇厶
闾	門口口
阄	門龜
阗	門十目廾
闿	門山巳
瘿	疒貝貝女
阏	門方人冫
阁	門夂口
阍	門氏日
闵	門文
阆	門丶艮
阖	門土厶皿
阙	門䒑屮欠
疭	疒人人
痪	疒𠂊冂大
痉	疒㇕丶工
瘆	疒厶大彡
怃	心一尤
鹚	䒑幺幺鳥
恸	心二厶力
盖	羊皿
羟	羊㇕丶工
郸	八甲一阝
粝	米厂一力
粪	米艹廾
糁	米厶大彡
𥻗	米木日一
惬	心匚大䒑
愦	心中一貝
愠	心日皿
恻	心貝刂
炜	火㐄
烩	火人二厶
𬉼	火匚乂
炖	火一屮
㸆	火牛口非
炽	火口八
炝	火人卩
烂	火䒑二
炉	火户
怆	心人卩
怿	心又キ
涞	氵木䒑
喾	⺍冖牛口
鲎	⺍冖魚
懑	氵艹一冂人人心
渎	氵十㇕冫大
滢	氵艹冖王丶
涝	氵艹冖力
濑	氵木口𠂊貝
濒	氵止癶頁
溃	氵中一貝
灏	氵日亠口小頁
滥	氵刂𠂉丶皿
鲨	氵小丿魚
浍	氵人二厶
溆	氵亼木又
沧	氵人卩
泺	氵𠂆木
浏	氵文刂
浒	氵言午
济	氵齊
湾	氵大八弓
泻	氵冖一乚一
泾	氵㇕丶工
滪	氵予頁
渌	氵彐水
寝	宀爿彐冖又
窜	穴中中
窝	穴咼
窦	穴十㇕冫大
祎	示㐄
祢	示竹八
禄	示彐水
衬	衤寸
裢	衤之車
裥	衤門日
褛	衤婁
皲	冖車皮
郓	冖車阝
鸩	冖儿鳥
骠	馬西示
骁	馬戈兀
骋	馬由丂
鹛	尸目鳥
驸	馬亻寸
刭	㇕丶工刂
颡	又又又木頁
鹬	予丿冂八口鳥
鹜	予丿攵鳥
骛	予丿攵馬
双	又又
骚	馬又丶虫
骎	馬彐冖又
书	㇕㇕丨丶
堕	阝𠂇月土
骘	阝止癶馬
陨	阝口貝
险	阝亼⺍一
翚	习习冖車
陉	阝㇕丶工
缙	糸一业日
绠	糸一日乂
缬	糸士口頁
缰	糸三田田
缜	糸十目廾
缥	糸西示
绮	糸大丁口
缭	糸一火日小
绂	糸犬㇕
绒	糸戈𠂇
辔	車糸糸口
粜	屮凵米
缲	糸口口口木
缱	糸之中一㠯
绅	糸申
绱	糸小冂口
缆	糸刂𠂉丶見
绲	糸日匕匕
缌	糸田心
缳	糸四一口衤
缈	糸目小丿
娇	女丿大刂
嫒	女爪冖𠂇又
娆	女戈兀
嫱	女十䒑圍口
媪	女日皿
姹	女宀丿七
嬷	女广木木丿厶
嫔	女宀斤廾
驽	女又馬
纥	糸𠂉乙
缒	糸之丿㠯
缑	糸亻コ矢
绶	糸爪冖又
绛	糸夂㐄
纰	糸匕匕
缟	糸亠口冂口
缡	糸亠乂凵冂厶
绞	糸亠八乂
缔	糸亠八冖巾
缢	糸䒑八皿
缣	糸禾禾彐
绻	糸半卩
绨	糸弋弓
缕	糸婁
缤	糸宀斤廾
绎	糸又キ
缀	糸又又又又
缗	糸巳七日
缪	糸习习人彡
鸶	糸糸鳥
缁	糸巛田
绌	糸屮凵
