的	白勹丶
了	了
我	手戈
是	日一止
在	一亻土
你	亻𠂉小
你	亻𠂊小
你	亻竹八
和	禾口
有	𠂇月
不	不
就	亠口小尤
都	耂阝
也	也
要	西女
吧	口巴
好	女子
他	亻也
說	言八口儿
去	土厶
到	至刂
沒	氵勹又
還	之四一口衤
上	上
對	业羊寸
那	刀二阝
人	人
個	亻圍十口
看	手目
中	中
呢	口尸匕
來	木人人
嗎	口馬
爲	爲
會	亼四日
她	女也
與	臼一乚丨廾
給	糸亼口
等	竹土寸
這	之言
用	用
把	扌巴
下	下
恩	圍大心
能	厶月匕匕
很	行艮
多	夕夕
做	亻十口攵
想	木目心
點	四土火卜口
點	田土火卜口
被	衤皮
地	土也
而	而
一	一
後	行幺夂
又	又
從	行人人止
再	一冂土
將	爿䏑寸
時	日土寸
但	亻日一
過	之咼
打	扌丁
大	大
年	𠂉㐄
麼	广木木幺
麼	广十儿十儿幺
啦	口扌立
以	厶人
買	四貝
讓	言衣口口甘
嗯	口圍大心
着	羊目
小	小
得	行日一寸
先	牛儿
啊	口阝丁口
或	戈口一
呀	口牙
找	扌戈
新	立木斤
及	𠂊又
跟	足艮
於	方人冫
太	大丶
嘛	口广木木
嘛	口广十儿十儿
號	口丂虎
日	日
才	十丿
可	丁口
比	匕匕
玩	王一兀
們	亻門
最	日耳又
最	冖二耳又
月	月
真	十目廾
吃	口𠂉乙
發	癶弓殳
並	立立
它	宀匕
其	甘廾
話	言舌
請	言丰月
錢	金戈戈
叫	口凵
開	門一廾
出	屮凵
誰	言隹
哈	口亼口
當	小冖口田
向	宀口
家	宀豕
問	門口
之	之
更	一日乂
該	言亠凵人
走	走
快	心㇕大
別	口力刂
前	䒑月刂
由	由
高	亠口冂口
您	亻𠂉小心
您	亻𠂊小心
您	亻竹八心
裏	衣田土
加	力口
所	户斤
天	一大
卻	八人口卩
已	巳
里	田土
內	冂人
寫	宀臼勹火
啥	口亼十口
老	耂匕
搞	扌亠口冂口
行	行
事	一中彐
拿	亼口手
帶	廿儿冖巾
如	女口
死	一夕匕
賣	士四貝
暈	日冖車
像	亻召豕
使	亻一口乂
剛	冂䒑山刂
成	戊㇕
無	𠂉廿廿火
換	扌𠂊冂八大
只	口八
哪	口刀二阝
愛	爪冖心夂
回	圍口
聽	耳王十四一心
少	小丿
元	一兀
喫	口丰刀大
卡	上卜
靠	牛口非
幫	土土寸白巾
算	竹目廾
者	耂
忙	心亡
起	走巳
各	夂口
學	臼乂乂冖子
分	八刀
咯	口夂口
總	糸囟夂心
總	糸囟丿乂心
則	貝刂
水	水
張	弓長
改	巳攵
唉	口厶矢
三	三
見	見
連	之車
車	車
放	方攵
全	人王
按	扌宀女
區	匚口口口
萬	艹日冂厶
機	木幺幺戈人
早	日十
拉	扌立
弄	王廾
本	木一
偶	亻日冂厶
頁	頁
進	之隹
性	心生
第	竹弋弓
完	宀一兀
同	冂一口
花	艹亻匕
長	長
怕	心白
女	女
講	言甘冂土
殺	乂木殳
組	糸且
錯	金廿日
些	止匕二
住	亻丶王
名	夕口
跑	足勹巳
次	二欠
次	冫欠
網	糸冂䒑亡
睡	目千艹二
裝	爿士衣
哦	口手戈
挺	扌廴工一
挺	扌廴丿士
挺	扌廴亻土
王	王
圖	圍口十圍口
掉	扌卜日十
路	足夂口
正	一止
外	夕卜
二	二
頭	一口䒑頁
應	广亻隹心
生	生
心	心
因	圍大
子	子
強	弓厶虫
類	米犬頁
類	米大頁
作	亻𠂉匕
送	之䒑大
書	彐キ日
每	𠂉母
法	氵土厶
乖	千北
拍	扌白
市	亠巾
撒	扌廿月攵
至	至
接	扌立女
美	羊大
表	丰衤
未	二木
辦	辛力辛
非	非
級	糸𠂊又
即	艮卩
哎	口艹乂
此	止匕
差	羊工
版	爿厂又
版	爿𠂆又
併	亻䒑廾
副	一口田刂
系	丿糸
收	凵攵
男	田力
俺	亻大申
字	宀子
兩	一巾人人
股	月殳
轉	車一日厶寸
便	亻一日乂
考	耂丂
塊	土鬼
線	糸白水
手	手
黃	廿一由八
道	之八頁
米	米
座	广人人土
豬	豕耂
聊	耳卯
取	耳又
低	亻氏一
低	亻氏丶
難	廿口夫隹
難	艹口夫隹
哇	口土土
兒	臼儿
受	爪冖又
包	勹巳
阿	阝丁口
喝	口日勹亡
白	白
金	金
四	四
近	之斤
管	竹宀㠯
定	宀一止
傳	亻一日厶寸
門	門
樣	木羊丶水
夠	夕夕勹口
交	亠八乂
李	木子
笑	竹丿大
自	自
邊	之自穴方
型	一廾刂土
黑	四土火
慢	心日四又
慢	心冖二四又
刷	尸巾刂
穿	穴牙
越	走戈乚
位	亻立
貴	中一貝
部	立口阝
稱	禾爪冂土
處	虎夂几
選	之巳巳艹廾
站	立卜口
牛	牛
怪	心又土
省	小丿目
倒	亻至刂
談	言火火
曾	八四日
羣	尹口羊
經	糸一巛工
數	婁攵
據	扌虎豕
變	言糸糸攵
累	田糸
汗	氵干
查	木日一
象	召豕
半	半
陳	阝木日
紅	糸工
格	木夂口
五	二乂
五	工㇕
幹	十日十人干
樓	木婁
方	方
讀	言士四貝
頂	丁頁
某	甘木
條	亻丨夂木
條	亻丨攵木
亂	爪龴冂厶龴乚
唔	口二乂口
唔	口工㇕口
馬	馬
遠	之土口衤
單	口口甲一
海	氵𠂉母
相	木目
熱	土儿土丸火
熱	土八土丸火
光	小兀
咋	口𠂉匕
風	風
且	且
林	木木
滿	氵廿巾人人
額	宀夂口頁
化	亻匕
班	王刂王
滴	氵亠八冂十口
掛	扌土土卜
關	門幺幺凵凵
漲	氵弓長
店	广卜口
安	宀女
坐	人人土
約	糸勹丶
飛	乙冫丿刂乙冫
劉	卯金刂
度	广廿又
種	禾千日土
俄	亻手戈
歌	丁口丁口欠
報	土半卩又
信	亻言
若	艹𠂇口
原	厂白小
文	文
飯	食厂又
飯	食𠂆又
晚	日召儿
量	日一田土
村	木寸
式	弋工
空	穴工
山	山
賺	貝禾禾彐
毛	毛
重	千日土
主	丶王
另	口力
間	門日
裡	衤田土
貼	貝卜口
入	人
伐	亻戈
血	丿皿
盤	舟殳皿
爽	大乂乂乂乂
隊	阝八豕
楊	木日一勿
臺	士口冖至
往	行丶王
片	爿
國	圍戈口一
狗	犭勹口
歲	止戊一癶
費	弓刂貝
壞	土衣四水
龍	龍
離	亠乂凵冂厶隹
共	艹廾
西	西
佔	亻卜口
周	用口
超	走召
明	日月
媽	女馬
均	土勹冫
均	土勹二
期	甘廾月
達	之土羊
照	日召火
切	七刀
留	卯田
動	千日土力
特	牛土寸
氣	气米
係	亻丿糸
神	示申
鳥	鳥
畫	彐キ田一
夢	艹四冖夕
教	耂子攵
哥	丁口丁口
甘	甘
蠻	言糸糸虫
魚	魚
值	亻十目
鎮	金十目廾
么	丿厶
罵	四馬
陪	阝立口
既	艮旡
哭	口口犬
力	力
建	廴彐キ
洗	氵牛儿
懂	心艹千日土
雙	隹隹又
口	口
指	扌匕日
東	木日
球	王十⺍丶
仍	亻㇕丿
活	氵舌
跌	足手丶
練	糸木四
練	糸木日
億	亻立日心
清	氵丰月
提	扌日一止
除	阝亼木
通	之龴用
酒	氵酉
貓	豸艹田
餓	食手戈
票	西示
六	亠八
病	疒一冂人
咩	口羊
假	亻尸二コ又
久	𠂊丶
段	厂三殳
平	干八
抓	扌爪
套	大長
課	言田木
急	𠂊彐心
藥	艹白幺幺木
城	土戊㇕
任	亻工一
任	亻丿士
草	艹日十
羅	四糸隹
理	王田土
令	亼卩
令	亼龴
雨	雨
貨	亻匕貝
唱	口日日
左	𠂇工
藍	艹臣𠂉丶皿
藍	艹臣𠂉一皿
縣	目木丿糸
常	小冖口巾
色	𠂊巴
搶	扌人户口
菜	艹爪木
喲	口糸勹丶
集	隹木
感	戊一口心
房	户方
較	車亠八乂
混	氵日匕匕
敢	丁耳攵
敢	㇕耳攵
火	火
臉	月亼口口人人
操	扌口口口木
南	十冂半
退	之艮
件	亻牛
吳	口乚大
破	石皮
聲	士尸殳耳
德	行十四一心
雪	雨彐
局	尸㇕口
雲	雨二厶
噢	口宀米大
整	木口攵一止
傻	亻囟儿夂
傻	亻囟八夂
華	華
克	十口儿
呃	口厂卩
喊	口戊一口
現	王見
跳	足儿⺍
養	羊丶艮
補	衤甫
團	圍一日厶寸
沈	氵冖儿
反	厂又
反	𠂆又
樂	白幺幺木
篇	竹户冊
待	行土寸
砸	石匚巾
深	氵冖儿木
深	氵冖八木
煩	火頁
根	木艮
求	十⺍丶
投	扌殳
電	雨申
親	立木見
惡	亞心
葉	艹廿乚木
款	士示欠
知	矢口
八	八
配	酉巳
器	口口犬口口
器	口口大口口
何	亻丁口
率	亠幺⺍十
調	言用口
鬼	鬼
修	亻丨夂彡
修	亻丨攵彡
試	言弋工
謝	言身寸
麪	木人人夂丁乚㇕
僅	亻艹口丰
僅	亻廿口丰
層	尸八四日
層	尸八田日
面	頁圍
週	之用口
北	北
木	木
份	亻八刀
記	言巳
趙	走小月
情	心丰月
肉	䏑
需	雨而
七	七
論	言亼冊
流	氵亠厶川
噶	口艹日勹亡
招	扌召
痛	疒龴用
列	一夕刂
石	石
香	禾日
封	土土寸
眼	目艮
易	日勿
冷	冫亼卩
冷	冫亼龴
借	亻廿日
派	氵𠂆亻
帥	丿㠯巾
付	亻寸
十	十
廠	广小冂口攵
陽	阝日一勿
樹	木士口䒑寸
油	氵由
胡	十口月
排	扌非
停	亻亠口冖丁
合	亼口
軍	冖車
身	身
奧	宀釆大
章	立日十
科	禾冫十
倆	亻一巾人人
星	日生
牌	爿鬼十
權	木艹口口隹
翻	釆田习习
隨	阝之𠂇工月
場	土日一勿
帖	巾卜口
商	亠八冂儿口
商	亠八冂八口
庫	广車
價	亻西貝
物	牛勿
泡	氵勹巳
寶	宀王午凵貝
玉	王丶
體	骨曲一口䒑
追	之丿㠯
傷	亻𠂉日一勿
背	北月
腳	月八人口卩
丟	王厶
劍	亼口口人人刂
解	𠂊用刀牛
室	宀至
底	广氏一
底	广氏丶
業	业半木
代	亻弋
孫	子丿糸
朱	𠂉木
亦	大八
須	彡頁
舊	艹隹臼
乾	十日十𠂉乙
工	工
咱	口自
詞	言㇕一口
刀	刀
喔	口尸至
波	氵皮
證	言癶一口䒑
鐵	金十戈口王
鐵	金十戈口亻土
推	扌隹
落	艹氵夂口
節	竹艮卩
春	丰日
輕	車一巛工
笨	竹木一
九	九
輸	車亼月刂
輸	車亼月巛
江	氵工
短	矢一口䒑
含	亼㇕口
千	千
炒	火小丿
藉	艹耒廿日
丫	八丨
徐	行亼木
騙	馬户冊
秒	禾小丿
青	丰月
耍	而女
夜	亠亻夂丶
許	言午
咁	口甘
吹	口欠
師	丿㠯一巾
板	木厂又
板	木𠂆又
土	土
贏	亡口月貝凡
姐	女且
直	十目
公	八厶
苦	艹十口
秀	禾㇕丿
博	十甫寸
皮	皮
朝	十日十月
君	尹口
詩	言土寸
爛	火門木四
爛	火門木日
靜	丰月爪尹
利	禾刂
素	丰糸
立	立
存	一亻子
燒	火土土土兀
斷	匕幺幺幺幺乚斤
吾	二乂口
吾	工㇕口
虧	虎隹一丂
虧	虎隹丂一
湯	氵日一勿
民	巳七
極	木了口又一
極	木丂口又一
命	亼口卩
睇	目弋弓
忘	亡心
茶	艹人木
冰	冫水
供	亻艹廾
案	宀女木
田	田
初	衤刀
品	口口口
抽	扌由
造	之牛口
抱	扌勹巳
野	田土予
綠	糸彑水
項	工頁
獎	爿䏑寸犬
胖	月半
緊	臣又糸
故	十口攵
服	月卩又
盡	尹一火皿
百	一白
兵	斤廾
英	艹冂大
蘇	艹魚禾
般	舟殳
演	氵宀一由八
嘴	口止匕𠂊用
簽	竹亼口口人人
填	土十目廾
果	田木
保	亻口木
唐	广尹口
雞	爪幺大隹
夏	頁夂
莫	艹日大
硬	石一日乂
寒	宀甘八冫
挖	扌穴乙
凡	凡
髮	長彡犬丿
髮	長彡犬㇕
言	言
題	日一止頁
防	阝方
街	行土土
距	足匚コ
挑	扌儿⺍
純	糸丿屮
純	糸一屮
鬧	鬥亠巾
欲	八人口欠
竟	立日儿
源	氵厂白小
官	宀㠯
戲	虎一口䒑戈
寄	宀大丁口
古	十口
首	八頁
思	田心
橋	木丿大口冂口
燈	火癶一口䒑
郭	亠口子阝
亮	亠口冖几
干	干
屬	尸水四勹虫
窮	穴身弓
粉	米八刀
爆	火日艹廾水
韓	十日十㐄口㐄
刪	冊刂
戴	十戈田艹廾
然	䏑犬火
衝	行千日土
疼	疒夂冫
雷	雨田
蓋	艹土厶皿
港	氵艹廾巳
租	禾且
狼	犭丶艮
蘭	艹門木四
蘭	艹門木日
狂	犭王
布	𠂇巾
引	弓丨
壓	厂日月犬土
亞	亞
捏	扌日土
齊	齊
隻	隹又
賽	宀甘八貝
員	口貝
佛	亻弓刂
食	食
船	舟八口
船	舟儿口
船	舟几口
今	亼㇕
恨	心艮
宋	宀木
銀	金艮
猛	犭子皿
客	宀夂口
黨	小冖口四土火
黨	小冖口田土火
雖	口虫隹
碼	石馬
友	𠂇又
領	亼卩頁
領	亼龴頁
句	勹口
斯	甘廾斤
沙	氵小丿
戰	口口甲一戈
哼	口亠口了
望	亡月王
望	亡月亻土
腿	月之艮
沖	氵中
丁	丁
園	圍土口衤
祝	示口儿
鄉	乚凵丶艮阝
牀	爿木
鄭	八酉大阝
界	田亻八
抗	扌亠几
步	止癶
河	氵丁口
缺	午凵㇕大
賊	貝戈𠂇
尚	小冂口
似	亻厶人
羊	羊
福	示一口田
必	弋八
遭	之一曲日
煙	火西土
否	不口
端	立山而
設	言殳
猜	犭丰月
伊	亻尹
秦	丰禾
秋	禾火
毒	丰母
架	力口木
熊	厶月匕匕火
持	扌土寸
廣	广廿由八
插	扌千臼
歸	丿㠯止彐冖巾
折	扌斤
滾	氵衣八口
靈	雨口口口工人人
意	立日心
呆	口木
基	甘廾土
困	圍木
圈	圍半卩
迷	之米
趕	走日干
踢	足日勿
勝	月半力
史	口乂
甲	甲
呵	口丁口
搬	扌舟殳
獲	犭艹隹又
紙	糸氏
乃	㇕丿
覺	臼乂乂冖見
右	𠂇口
塔	土艹亼口
準	氵隹十
拖	扌𠂉也
摸	扌艹日大
院	阝宀一兀
慘	心厶厶厶人彡
訂	言丁
散	廿月攵
松	木人厶
爸	八乂巴
喜	士口䒑口
洋	氵羊
語	言二乂口
語	言工㇕口
呈	口王
呈	口亻土
治	氵厶口
降	阝夂㐄
峯	山夂丰
漢	氵廿口夫
漢	氵艹口夫
富	宀一口田
姓	女生
料	米冫十
嘎	口頁戈
結	糸士口
閃	門人
咬	口亠八乂
梅	木𠂉母
批	扌匕匕
戶	户
足	足
寧	宀心皿丁
爬	爪巴
醒	酉日生
狠	犭艮
逛	之犭王
精	米丰月
瘦	疒臼丨又
瘋	疒風
踩	足爪木
槍	木人户口
誒	言厶矢
軟	車欠
偷	亻亼月刂
支	十又
杜	木土
麗	一冂丶一冂丶鹿
鞋	革土土
展	尸廿衤
咧	口一夕刂
興	臼冂一口廾
依	亻衣
倍	亻立口
康	广尹⺍
堂	小冖口土
救	十⺍丶攵
觀	艹口口隹見
鍵	金廴彐キ
製	牛巾刂衣
餘	食亼木
冇	𠂇冂
筆	竹彐キ
音	立日
世	廿乚
著	艹耂
仲	亻中
舞	𠂉廿廿夕㐄
吖	口八丨
守	宀寸
露	雨足夂口
冒	日目
冒	冖二目
昇	日丿廾
唄	口貝
榮	火火冖木
弱	弓冫弓冫
影	日亠口小彡
州	⺍川
替	夫夫日
逼	之一口田
陸	阝土儿土
陸	阝土八土
曲	曲
願	厂白小頁
牙	牙
箱	竹木目
嚇	口土火土火
測	氵貝刂
莊	艹爿士
寬	宀艹見丶
遍	之户冊
細	糸田
狀	爿犬
巴	巴
閒	門月
武	戈止
湖	氵十口月
聯	耳幺幺凵凵
程	禾口王
程	禾口亻土
柳	木卯
偏	亻户冊
實	宀母貝
印	臼卩
味	口二木
鎖	金小貝
衆	丿皿亻
零	雨亼卩
零	雨亼龴
環	王四一口衤
角	𠂊用
紫	止匕糸
勒	革力
島	鳥山
耶	耳阝
熟	亠口子丸火
孔	子乚
寸	寸
標	木西示
歐	匚口口口欠
厚	厂日子
答	竹亼口
社	示土
懶	心木口𠂊貝
懶	心木口刀貝
顧	户隹頁
順	川頁
滅	氵戊一火
運	之冖車
輪	車亼冊
兼	禾禾彐
溫	氵圍人皿
娘	女丶艮
登	癶一口䒑
悶	門心
微	行山一几攵
佳	亻土土
瞭	目一火日小
雅	牙隹
魔	广木木鬼
魔	广十儿十儿鬼
司	㇕一口
拋	扌尤力
志	士心
奇	大丁口
編	糸户冊
瓦	瓦
居	尸十口
憑	冫馬心
盛	戊㇕皿
奶	女㇕丿
虎	虎
后	𠂆一口
洞	氵冂一口
台	厶口
形	一廾彡
佢	亻匚コ
負	𠂊貝
川	川
檔	木小冖口田
圓	圍口貝
牆	爿土人人圍口
囧	圍八冂
充	亠厶儿
害	宀丰口
喂	口田衤
免	召儿
景	日亠口小
擬	扌匕矢龴足
穩	禾爪工彐心
曹	一曲日
曉	日土土土兀
煮	耂火
良	丶艮
蛋	足虫
吐	口土
肥	月巴
仙	亻山
宮	宀口丿口
碰	石立立
酸	酉厶八夂
侯	亻コ矢
塞	宀甘八土
嘍	口婁
脫	月八口儿
勁	一巛工力
欠	欠
創	人户口刂
擦	扌宀䏑又示
爾	一八巾乂乂乂乂
藏	艹戈爿臣
皆	匕匕白
屁	尸匕匕
永	丶水
夫	夫
掙	扌爪尹
琴	王王亼㇕
錄	金彑水
餵	食田衤
稅	禾八口儿
宏	宀𠂇厶
例	亻一夕刂
專	一日厶寸
砍	石欠
視	示見
繼	糸匕幺幺幺幺
兄	口儿
產	文厂生
善	羊䒑口
增	土八四日
施	方𠂉也
淚	氵户犬
暗	日立日
忍	刀丶心
肯	止月
母	母
聖	耳口王
聖	耳口亻土
橫	木廿一由八
遊	之方𠂉子
艾	艹乂
致	至攵
宗	宀示
偉	亻㐄口㐄
麻	广木木
麻	广十儿十儿
怒	女又心
扔	扌㇕丿
爭	爪尹
游	氵方𠂉子
鄧	癶一口䒑阝
腰	月西女
嫩	女木口攵
肖	小月
淨	氵爪尹
罪	四非
仔	亻子
彈	弓口口甲一
丑	彐丨
減	氵戊一口
敏	𠂉母攵
義	羊手戈
棒	木丰キ
臭	自犬
臭	自大
響	乚凵丶艮阝立日
響	乚凵艮阝立日
聞	門耳
拆	扌斤丶
蔡	艹䏑又示
計	言十
絲	糸糸
校	木亠八乂
氏	氏
糖	米广尹口
吉	士口
押	扌甲
馮	冫馬
吵	口小丿
谷	八人口
麥	木人人夂
衣	衣
宇	宀丁一
雜	亠人人木隹
末	一木
潘	氵釆田
告	牛口
旁	亠八冖方
耐	而寸
董	艹千日土
榜	木亠八冖方
醉	酉亠人人十
鍾	金千日土
妹	女二木
鋼	金冂䒑山
蔣	艹爿䏑寸
幣	巾⺍攵巾
宜	宀且
尼	尸匕
灰	𠂇火
評	言干八
維	糸隹
絕	糸刀巴
屋	尸至
幾	幺幺戈人
楚	木木足
屆	尸土凵
館	食宀㠯
丹	冊丶
乘	禾北
認	言刀丶心
刻	亠凵人刂
俊	亻厶八夂
芳	艹方
抄	扌小丿
夾	大人人
酷	酉牛口
京	亠口小
嚴	口口厂丁耳攵
嚴	口口厂㇕耳攵
返	之厂又
返	之𠂆又
礦	石广廿由八
廳	广耳王十四一心
魯	魚日
瑞	王山而
仁	亻二
飄	西示風
註	言丶王
添	氵一大心
催	亻山隹
具	目廾
威	戊一女
劇	虎豕刂
核	木亠凵人
農	曲辰
瓶	䒑廾瓦
銅	金冂一口
犯	犭卩
族	方𠂉矢
季	禾子
尋	彐工口寸
顯	日幺幺火頁
骨	骨
嘿	口四土火
嘿	口田土火
鏈	金之車
擺	扌四厶月匕匕
擠	扌齊
黎	禾丿刀人水
騎	馬大丁口
密	宀弋八山
士	士
術	行木丶
術	行十儿丶
炸	火𠂉匕
祇	示氏
洪	氵艹廾
訊	言乙十
腦	月巛囟
禮	示曲一口䒑
容	穴人口
輝	小兀冖車
射	身寸
智	矢口日
索	十冖糸
聚	耳又亻
拼	扌䒑廾
燕	廿口北火
撞	扌立田土
膜	月艹日大
普	立立日
竹	竹竹
魏	禾女鬼
澤	氵四土半
乜	㇕乚
側	亻貝刂
諾	言艹𠂇口
呂	口丿口
范	艹氵卩
搭	扌艹亼口
鳳	几一鳥
袁	土口衤
扯	扌止
鑽	金牛儿牛儿貝
彭	士口䒑彡
陰	阝亼㇕二厶
唸	口亼㇕心
薄	艹氵甫寸
涼	氵亠口小
曰	日
胃	田月
鹽	臣𠂉卜圍乂皿
賴	木口𠂊貝
賴	木口刀貝
獨	犭四勹虫
窩	穴咼
堆	土隹
赴	走卜
載	十戈車
躲	身几木
孟	子皿
抵	扌氏一
抵	扌氏丶
甜	舌甘
舉	臼一乚丨廾キ
彩	爪木彡
甚	甘匚儿
甚	甘匚八
厄	厂卩
粗	米且
傑	亻夕㐄木
噸	口丿屮頁
噸	口一屮頁
慶	鹿㇕心夂
緣	糸彑豕
駐	馬丶王
申	申
衛	行㐄口㐄
訓	言川
念	亼㇕心
蕭	艹尹爿一爿
惹	艹𠂇口心
帳	巾長
勸	艹口口隹力
讚	言牛儿牛儿貝
盒	亼口皿
逃	之儿⺍
嘉	士口䒑力口
納	糸冂人
升	丿廾
倉	人户口
姚	女儿⺍
休	亻木
症	疒一止
斤	斤
功	工力
喇	口木口刂
釦	金口
浪	氵丶艮
扣	扌口
泰	丰水
忠	中心
梁	氵刀八木
吸	口𠂊又
貝	貝
跨	足大一丂
跨	足大丂一
盧	虎田皿
森	木木木
瞎	目宀丰口
卷	半卩
于	丁一
井	二刂
針	金十
蛇	虫宀匕
寺	土寸
購	貝甘冂土
導	之八頁寸
飲	食欠
噴	口十十十貝
虛	虎丘
屏	尸䒑廾
優	亻一白冖心夂
灌	氵艹口口隹
埋	土田土
略	田夂口
掃	扌彐冖巾
吶	口冂人
目	目
蒙	艹冖一豕
託	言丿七
托	扌丿七
巧	工丂
淡	氵火火
賤	貝戈戈
拜	手一丰
冬	夂冫
娜	女刀二阝
懷	心衣四水
池	氵也
敲	亠口冂口卜又
凱	山一口䒑几
鐘	金立田土
愁	禾火心
鋪	金甫
薩	艹阝立丿生
揚	扌日一勿
勇	龴用力
財	貝十丿
鍊	金木四
終	糸夂冫
質	斤斤貝
泥	氵尸匕
昏	氏日
遇	之日冂厶
喬	丿大口冂口
欄	木門木四
欄	木門木日
鍋	金咼
巨	匚コ
儀	亻羊手戈
遲	之尸水牛
怎	𠂉匕心
磨	广木木石
磨	广十儿十儿石
呼	口爪丁
賭	貝耂
液	氵亠亻夂丶
泉	白水
嫁	女宀豕
捲	扌半卩
汪	氵王
稍	禾小月
薛	艹丿㠯辛
賈	西貝
豆	一口䒑
頓	丿屮頁
頓	一屮頁
旺	日王
儂	亻曲辰
攻	工攵
祥	示羊
委	禾女
佐	亻𠂇工
臨	臣𠂉口口口
隔	阝一口冂八丁
繞	糸土土土兀
輛	車一巾人人
崔	山隹
溝	氵甘冂土
碗	石宀夕卩
賠	貝立口
吻	口勿
健	亻廴彐キ
速	之木口
失	手丶
雄	𠂇厶隹
胸	月勹乂凵
框	木匚王
鬥	鬥
暴	日艹廾水
湊	氵丰一大
陣	阝車
識	言立日戈
娃	女土土
唯	口隹
漏	氵尸雨
拔	扌犬丿
拔	扌犬㇕
洛	氵夂口
探	扌冖儿木
探	扌冖八木
碟	石廿乚木
郎	丶艮阝
珠	王𠂉木
劑	齊刂
尿	尸水
透	之禾㇕丿
惠	一日厶心
譚	言西日十
營	火火冖口口
營	火火冖口丿口
府	广亻寸
菲	艹非
叼	口㇕一
父	八乂
耳	耳
殘	一夕戈戈
窗	穴囟夂
窗	穴囟丿乂
搜	扌臼丨又
希	乂𠂇巾
患	中中心
尾	尸毛
播	扌釆田
岩	山石
逗	之一口䒑
廢	广癶弓殳
賢	臣又貝
限	阝艮
帝	亠八冖巾
昌	日日
模	木艹日大
磚	石一日厶寸
扁	户冊
舒	亼十口予
嫌	女禾禾彐
陶	阝勹午凵
苗	艹田
剪	䒑月刂刀
羽	习习
哩	口田土
稿	禾亠口冂口
棟	木木日
邦	丰阝
撿	扌亼口口人人
玲	王亼卩
玲	王亼龴
驚	艹勹口攵馬
坑	土亠几
備	亻廿丿用
撥	扌癶弓殳
袋	亻弋衣
趁	走人彡
妖	女丿大
甩	月乚
錦	金白巾
溼	氵一幺幺土
琳	王木木
乙	乙
伴	亻半
淺	氵戈戈
尊	八酉寸
顏	文厂彡頁
匯	匚氵隹
熬	士方攵火
熬	土方攵火
熬	丰力攵火
吊	口巾
霜	雨木目
沿	氵八口
沿	氵儿口
沿	氵几口
伯	亻白
盜	氵欠皿
浩	氵牛口
剩	禾北刂
域	土戈口一
祖	示且
肺	月亠巾
肺	月一巾
附	阝亻寸
制	牛巾刂
玄	亠幺
置	四十目
豪	亠口冖豕
恆	心二𠂊冫
助	且力
濤	氵士㇕工一口寸
幽	幺幺山
欣	斤欠
豐	丰丰山一口䒑
辣	辛木口
煤	火甘木
戀	言糸糸心
圍	圍㐄口㐄
瓜	瓜
諸	言耂
俾	亻鬼十
慧	丰丰彐心
墨	四土火土
墨	田土火土
鮮	魚羊
鏡	金立日儿
娶	耳又女
蝦	虫尸二コ又
犬	犬
鵬	月月鳥
誠	言戊㇕
賀	力口貝
險	阝亼口口人人
飾	食𠂉巾
撐	扌小冖口牙
炎	火火
震	雨辰
鋒	金夂丰
遂	之八豕
斌	文戈止
軒	車干
控	扌穴工
殼	士冖一几殳
擋	扌小冖口田
覆	西行𠂉日夂
趟	走小冂口
禁	木木示
烤	火耂丂
盃	不皿
童	立田土
蟲	虫虫虫
徵	行山一王攵
靚	丰月見
杯	木不
暨	艮旡日一
晴	日丰月
魂	二厶鬼
益	䒑八皿
庭	广廴工一
庭	广廴丿士
庭	广廴亻土
肝	月干
濃	氵曲辰
坊	土方
晨	日辰
紀	糸巳
振	扌辰
塵	鹿土
割	宀丰口刂
敗	貝攵
消	氵小月
兆	儿⺍
楓	木風
隆	阝夂一生
撤	扌亠厶月攵
粥	弓米弓
馨	士尸殳禾日
誤	言口一大
誤	言口乚大
誤	言口乚廾
滑	氵骨
噠	口之土羊
曼	日四又
曼	冖二四又
暖	日爪一𠂇又
滬	氵户口巴
己	巳
止	止
柱	木丶王
塗	氵亼木土
妻	一尹女
灣	氵言糸糸弓
盾	𠂆十目
奔	大十艹
潤	氵門王
政	一止攵
爹	八乂夕夕
尹	尹
廖	广习习人彡
刺	木冂刂
冠	冖一兀寸
躺	身小冂口
舍	亼十口
鑫	金金金
蓮	艹之車
售	隹口
獸	口口田一口犬
婚	女氏日
攝	扌耳耳耳
醫	匚矢殳酉
閣	門夂口
妞	女彐丨
邱	丘阝
兔	召儿丶
敬	艹勹口攵
潮	氵十日十月
昂	日匕卩
飽	食勹巳
咳	口亠凵人
邪	牙阝
促	亻足
鼠	臼釆
葛	艹日勹亡
串	中中
桑	又又又木
續	糸士四貝
苑	艹夕卩
迎	之匕卩
弓	弓
碎	石亠人人十
余	亼木
承	㇕水三
迪	之由
膠	月习习人彡
烏	烏
牠	牛也
臣	臣
勤	艹口丰力
勤	廿口丰力
摔	扌亠幺⺍十
撈	扌火火冖扌力
蒸	艹㇕水一火
凌	冫土儿夂
凌	冫土八夂
辛	辛
旗	方𠂉甘廾
妙	女小丿
始	女厶口
符	竹亻寸
倫	亻亼冊
鋁	金口口
鋁	金口丿口
亭	亠口冖丁
吼	口子乚
云	二厶
研	石一廾
咪	口米
俗	亻八人口
爺	八乂耳阝
啓	户攵口
霧	雨予丿夂力
珍	王人彡
卓	卜日十
韋	㐄口㐄
歡	艹口口隹欠
嗨	口氵𠂉母
積	禾丰貝
擡	扌士口冖至
捧	扌丰キ
鳴	口鳥
舔	舌一大心
贊	牛儿牛儿貝
喃	口十冂半
簡	竹門日
豔	丰丰山一口䒑土厶皿
愈	亼月刂心
愈	亼月巛心
溪	氵爪幺大
罰	四言刂
歪	不一止
晃	日小兀
斜	亼木冫十
預	予頁
鄒	勹屮勹屮阝
崗	山冂䒑山
尤	尤
洲	氵⺍川
乎	爪丁
湘	氵木目
罷	四厶月匕匕
軸	車由
妳	女𠂉小
妳	女𠂊小
妳	女竹八
翔	羊习习
異	田艹廾
隱	阝爪工彐心
枝	木十又
逸	之召儿丶
逸	之召儿
哄	口艹廾
餐	卜夕又食
顆	田木頁
鴨	甲鳥
染	氵九木
餅	食䒑廾
粘	米卜口
藝	艹土儿土丸二厶
藝	艹土八土丸二厶
炮	火勹巳
桌	卜日木
芬	艹八刀
鴻	氵工鳥
攜	扌山隹冂儿口
攜	扌山隹冂八口
腎	臣又月
撲	扌业半大
萍	艹氵干八
晶	日日日
勾	勹厶
戒	戈廾
桂	木土土
朗	丶艮月
堵	土耂
矣	厶矢
捐	扌口月
彎	言糸糸弓
薑	艹三田田
荷	艹亻丁口
畝	亠田𠂊丶
棉	木白巾
私	禾厶
擊	車凵殳手
姜	羊女
貸	亻弋貝
嗲	口八乂夕夕
傾	亻匕頁
鼓	士口䒑十又
霞	雨尸二コ又
瞧	目隹火
皇	白王
企	人止
互	一彑
沉	氵冖几
箭	竹䒑月刂
柏	木白
騰	月半馬
焦	隹火
憋	巾⺍攵心
潔	氵丰刀糸
盟	日月皿
延	廴丿止
柔	予丿木
資	二欠貝
資	冫欠貝
粒	米立
嶺	山亼卩頁
嶺	山亼龴頁
盆	八刀皿
檢	木亼口口人人
護	言艹隹又
眉	尸目
傘	人人人人人十
碧	王白石
籍	竹耒廿日
燙	氵日一勿火
瑪	王馬
刮	舌刂
勿	勿
坤	土申
汁	氵十
冊	冊
銘	金夕口
浴	氵八人口
翼	习习田艹廾
哲	扌斤口
涵	氵丂⺍凵
涵	氵了⺍凵
鈣	金下乚
菌	艹圍禾
敵	亠八冂十口攵
桶	木龴用
抹	扌一木
判	半刂
寵	宀龍
紋	糸文
弟	弋弓
傅	亻甫寸
衰	衣口一
譯	言四土半
柯	木丁口
叔	上小又
肩	户月
殿	尸艹廾殳
番	釆田
驢	馬虎田皿
怡	心厶口
旭	九日
訪	言方
勢	土儿土丸力
勢	土八土丸力
蒐	艹鬼
航	舟亠几
妮	女尸匕
萊	艹木人人
坡	土皮
兇	乂凵儿
旅	方𠂉亻
鷹	广亻隹鳥
赤	土火
技	扌十又
韻	立日口貝
摘	扌亠八冂十口
翠	习习亠人人十
邁	之艹日冂厶
孝	耂子
移	禾夕夕
搖	扌䏑午凵
畢	甲艹二
予	予
岳	丘山
屎	尸米
融	一口冂八丁虫
棋	木甘廾
勞	火火冖力
採	扌爪木
鈕	金彐丨
扶	扌夫
介	亻八
渡	氵广廿又
芯	艹心
奪	大隹寸
采	爪木
乳	爪子乚
拳	半手
浜	氵斤廾
齣	齒勹口
錫	金日勿
薇	艹行山一几攵
淫	氵爪工一
淫	氵爪丿士
拽	扌申丿
職	耳立日戈
宅	宀丿七
掌	小冖口手
培	土立口
莉	艹禾刂
損	扌口貝
櫃	木匚中一貝
盼	目八刀
握	扌尸至
謀	言甘木
廟	广十日十月
截	十戈隹
酶	酉𠂉母
孤	子瓜
壯	爿士
邵	召阝
墊	土半丸土
規	夫見
頗	皮頁
什	亻十
宣	宀二日
妍	女一廾
尖	小大
討	言寸
醋	酉廿日
朵	几木
膽	月𠂊厂八言
穆	禾白小彡
姬	女臣
龜	龜
啃	口止月
漸	氵車斤
耗	耒毛
息	自心
伍	亻二乂
伍	亻工㇕
塘	土广尹口
壽	士㇕工一口寸
逢	之夂丰
闖	門馬
晉	二厶厶日
桃	木儿⺍
壁	尸口辛土
霍	雨隹
爐	火虎田皿
漆	氵木人水
暫	車斤日
虹	虫工
丸	丸
券	半刀
獃	山一口䒑犬
辭	爪龴冂厶龴辛
縫	糸之夂丰
俱	亻目廾
菊	艹勹米
奴	女又
岸	山厂干
凝	冫匕矢龴足
膩	月弋二貝
芝	艹之
兮	八丂
脈	月𠂆亻
嚐	口小冖口匕日
烈	一夕刂火
矮	矢禾女
貪	亼㇕貝
婆	氵皮女
俞	亼月刂
蝶	虫廿乚木
誇	言大一丂
誇	言大丂一
枕	木冖儿
毀	臼土殳
避	之尸口辛
郝	土火阝
帕	巾白
綁	糸丰阝
悅	心八口儿
浮	氵爪子
盈	㇕丿又皿
枚	木攵
材	木十丿
賞	小冖口貝
扎	扌乚
翁	八厶习习
幻	幺㇕
衫	衤彡
杆	木干
固	圍十口
耀	小兀习习隹
槽	木一曲日
穴	穴
獻	虎一口冂八丁犬
幅	巾一口田
審	宀釆田
斬	車斤
伸	亻申
悲	非心
殷	𠂆彐㇕殳
茲	艹幺幺
穎	匕禾頁
萌	艹日月
斑	王文王
澡	氵口口口木
牽	亠幺冖牛
屈	尸屮凵
娟	女口月
怨	夕卩心
癢	疒羊丶艮
恐	工凡心
凍	冫木日
複	衤𠂉日夂
柴	止匕木
逆	之䒑屮
僞	亻爲
騷	馬又冫虫
騷	馬又丶虫
渣	氵木日一
熙	臣巳火
抖	扌冫十
忽	勿心
津	氵彐キ
胎	月厶口
糧	米日一田土
濟	氵齊
參	厶厶厶人彡
譜	言立立日
准	冫隹
褲	衤广車
紮	木乚糸
摩	广木木手
摩	广十儿十儿手
縮	糸宀亻一白
漫	氵日四又
漫	氵冖二四又
溜	氵卯田
彥	文厂彡
棄	亠厶廿木
扇	户习习
婷	女亠口冖丁
菸	艹方人冫
脣	辰月
憂	一白冖心夂
堡	亻口木土
淘	氵勹午凵
墓	艹日大土
鹿	鹿
攢	扌牛儿牛儿貝
嬌	女丿大口冂口
遞	之𠂆虎
彬	木木彡
蹭	足八四日
蹭	足八田日
卿	丿凵艮卩
琪	王甘廾
鶴	冖隹鳥
函	丂⺍凵
函	了⺍凵
確	石冖隹
郡	尹口阝
奈	大示
茂	艹戊
緩	糸爪一𠂇又
協	十力力力
瓊	王𠂊冂人目夂
髒	骨艹一夕匕廾
債	亻丰貝
肌	月几
薰	艹千四二火
映	日冂大
粵	宀釆一丂
粵	宀釆丂一
鼻	自田廾
泵	石水
銷	金小月
育	亠厶月
澳	氵宀米大
陞	阝丿廾土
候	亻丨コ矢
堅	臣又土
种	禾中
邀	之白方攵
閉	門十丿
妝	爿女
噻	口宀甘八土
佩	亻几一巾
決	氵㇕大
適	之亠八冂十口
策	竹木冂
藤	艹月半水
仿	亻方
磊	石石石
雁	厂亻隹
俠	亻大人人
腸	月日一勿
窄	穴𠂉匕
昨	日𠂉匕
倪	亻臼儿
務	予丿夂力
雯	雨文
戈	戈
爪	爪
癌	疒口口口山
效	亠八乂攵
拷	扌耂丂
猴	犭亻コ矢
掏	扌勹午凵
汝	氵女
撮	扌日耳又
撮	扌冖二耳又
幸	土半
揉	扌予丿木
醬	爿䏑寸酉
舟	舟
訴	言斤丶
態	厶月匕匕心
盯	目丁
繡	糸尹爿一爿
蜜	宀弋八虫
漂	氵西示
序	广予
巷	艹廾巳
梨	禾刂木
舌	舌
蒂	艹亠八冖巾
腹	月𠂉日夂
蟹	𠂊用刀牛虫
陷	阝𠂊臼
捉	扌足
蒼	艹人户口
鵝	手戈鳥
疑	匕矢龴足
鼎	目爿爿
釣	金勹丶
慌	心艹亡川
蔥	艹囟夂心
蔥	艹囟丿乂心
瘤	疒卯田
彼	行皮
辰	辰
執	土半丸
忌	巳心
踏	足水日
龔	龍艹廾
捷	扌一彐止
罐	午凵艹口口隹
腫	月千日土
縱	糸行人人止
伏	亻犬
壇	土亠圍口日一
觸	𠂊用四勹虫
默	四土火犬
默	田土火犬
懸	目木丿糸心
赫	土火土火
瑩	火火冖王
杰	木火
孩	子亠凵人
咖	口力口
幀	巾卜貝
悟	心二乂口
悟	心工㇕口
頻	止癶頁
灑	氵一冂丶一冂丶鹿
燉	火亠口子攵
帽	巾日目
帽	巾冖二目
幼	幺力
旋	方𠂉足
擁	扌亠乚凵隹
聶	耳耳耳
猶	犭八酉
壹	士冖一口䒑
霸	雨革月
席	广廿巾
叉	又丶
繫	車凵殳糸
妃	女巳
擔	扌𠂊厂八言
典	冊廾
贈	貝八四日
贈	貝八田日
儒	亻雨而
裸	衤田木
奉	丰キ
叻	口力
御	行午止卩
腔	月穴工
突	穴犬
突	穴大
刑	一廾刂
痕	疒艮
賓	宀一癶貝
纔	糸召匕匕召儿丶
午	午
攤	扌廿口夫隹
攤	扌艹口夫隹
蕾	艹雨田
頸	一巛工頁
臟	月艹戈爿臣
宰	宀辛
囊	一中冖口口甘衤
賬	貝長
弘	弓厶
境	土立日儿
拒	扌匚コ
毅	立豕殳
煎	䒑月刂火
弦	弓亠幺
渝	氵亼月刂
渝	氵亼月巛
罩	四卜日十
蓉	艹穴人口
憶	心立日心
卵	卯丶丶
遷	之西大巳
遷	之西大卩
尺	尸丶
禍	示咼
逾	之亼月刂
逾	之亼月巛
垂	千艹二
潛	氵旡旡日
郵	千艹二阝
惜	心廿日
浦	氵甫
警	艹勹口攵言
扛	扌工
氧	气羊
揭	扌日勹亡
逐	之豕
謂	言田月
昭	日召
宿	宀亻一白
統	糸亠厶儿
裂	一夕刂衣
僧	亻八四日
僧	亻八田日
慣	心母貝
裙	衤尹口
彪	虎彡
淋	氵木木
束	木口
牢	宀牛
齋	齊示
揍	扌丰一大
仕	亻士
鉤	金勹口
劫	土厶力
拓	扌石
扮	扌八刀
疊	田田田冖且
鋅	金辛
喻	口亼月刂
律	行彐キ
株	木𠂉木
砂	石小丿
埃	土厶矢
斗	冫十
坪	土干八
揮	扌冖車
箇	竹圍十口
仇	亻九
吞	一大口
亡	亡
沾	氵卜口
遙	之䏑午凵
壺	士冖亞
牧	牛攵
霖	雨木木
兜	白卯儿
寨	宀甘八木
掐	扌𠂊臼
監	臣𠂉丶皿
監	臣𠂉一皿
稀	禾乂𠂇巾
恰	心亼口
牴	牛氏一
牴	牛氏丶
棍	木日匕匕
啵	口氵皮
朕	月䒑大
淑	氵上小又
饒	食土土土兀
慕	艹日大心
歇	日勹亡欠
疏	足亠厶川
膏	亠口冖口月
陵	阝土儿夂
陵	阝土八夂
壩	土雨革月
纏	糸广田土八土
鹹	卜圍乂戊一口
姆	女母
聰	耳囟夂心
聰	耳囟丿乂心
捱	扌厂土土
碳	石山𠂇火
銳	金八口儿
驗	馬亼口口人人
齒	齒
廷	廴工一
廷	廴丿士
廷	廴亻土
糊	米十口月
翹	土土土兀习习
儲	亻言耂
楠	木十冂半
顛	十目廾頁
蚊	虫文
祭	䏑又示
龐	广龍
嘞	口革力
拾	扌亼口
裴	非衣
朋	月月
媚	女尸目
芸	艹二厶
吟	口亼㇕
筒	竹冂一口
丘	丘
責	丰貝
趴	足八
堯	土土土兀
繁	𠂉母攵糸
坦	土日一
穗	禾一日厶心
紗	糸小丿
屯	丿屮
屯	一屮
虐	虎匚一
蹲	足八酉寸
紹	糸召
惟	心隹
幕	艹日大巾
澆	氵土土土兀
扒	扌八
搓	扌羊工
遮	之广廿火
庚	广彐人
哉	十戈口
涉	氵止癶
忒	弋心
賦	貝戈止
臂	尸口辛月
樁	木丰臼
敷	甫方攵
禪	示口口甲一
佬	亻耂匕
瑤	王䏑午凵
習	习习白
臥	臣人
釘	金丁
阮	阝一兀
丙	一冂人
歷	厂禾禾止
躍	足习习隹
署	四耂
範	竹車卩
示	示
邢	一廾阝
擰	扌宀心皿丁
莎	艹氵小丿
糞	米田艹廾
嵐	山風
濱	氵宀一癶貝
夕	夕
苯	艹木一
議	言羊手戈
趣	走耳又
渠	氵匚コ木
閱	門八口儿
繩	糸黽
杭	木亠几
疾	疒矢
崇	山宀示
擴	扌广廿由八
傢	亻宀豕
婦	女彐冖巾
涅	氵日土
裕	衤八人口
嘆	口廿口夫
嘆	口艹口夫
艦	舟臣𠂉丶皿
艦	舟臣𠂉一皿
挪	扌刀二阝
荒	艹亡川
貞	卜貝
筋	竹月力
孕	㇕丿子
撕	扌甘廾斤
鈴	金亼卩
鈴	金亼龴
戳	习习隹戈
帆	巾凡
籌	竹士㇕工一口寸
奎	大土土
駕	力口馬
阻	阝且
享	亠口子
棚	木月月
傲	亻士方攵
傲	亻土方攵
傲	亻丰力攵
欽	金欠
蹦	足山月月
焊	火日干
召	召
徒	行走
脂	月匕日
几	几
趨	走勹屮勹屮
艘	舟臼丨又
喵	口艹田
競	立口儿立口儿
靖	立丰月
奏	丰一大
咒	口口几
釋	釆四土半
盲	亡目
姿	二欠女
姿	冫欠女
炫	火亠幺
賜	貝日勿
湧	氵龴用力
潑	氵癶弓殳
坎	土欠
琦	王大丁口
拌	扌半
樊	木乂乂木大
缸	午凵工
弗	弓刂
狐	犭瓜
漿	爿䏑寸水
栽	十戈木
閻	門𠂊臼
攪	扌臼乂乂冖見
硅	石土土
述	之木丶
述	之十儿丶
籠	竹龍
泛	氵丿之
甫	甫
佑	亻𠂇口
鮑	魚勹巳
閥	門亻戈
卦	土土卜
耿	耳火
咽	口圍大
倩	亻丰月
袖	衤由
貧	八刀貝
糟	米一曲日
激	氵白方攵
階	阝匕匕白
珊	王冊
潭	氵西日十
蠢	丰日虫虫
植	木十目
占	卜口
嘯	口尹爿一爿
徑	行一巛工
鉛	金八口
鉛	金儿口
鉛	金几口
屍	尸一夕匕
倚	亻大丁口
灘	氵廿口夫隹
灘	氵艹口夫隹
姨	女大弓
災	巛火
幢	巾立田土
鈉	金冂人
暢	申日一勿
詠	言丶水
齡	齒亼卩
齡	齒亼龴
焉	一止一乚火
茹	艹女口
桐	木冂一口
痰	疒火火
捂	扌二乂口
捂	扌工㇕口
鄰	米夕㐄阝
癡	疒匕矢龴足
揀	扌木四
艙	舟人户口
謙	言禾禾彐
万	一力
織	糸立日戈
蒲	艹氵甫
芽	艹牙
佈	亻𠂇巾
驅	馬匚口口口
昊	日一大
轟	車車車
攔	扌門木四
攔	扌門木日
碑	石鬼十
嚼	口爪四艮寸
燃	火䏑犬火
摟	扌婁
輔	車甫
暉	日冖車
朴	木卜
碩	石頁
煲	亻口木火
杖	木一乂
謎	言之米
磷	石米夕㐄
竄	穴臼釆
脆	月𠂊厂卩
刃	刀丶
墜	阝八豕土
姑	女十口
衡	行𠂊田大
皺	勹屮勹屮皮
繳	糸白方攵
擇	扌四土半
櫻	木貝貝女
鹼	卜圍乂亼口口人人
窯	穴羊火
措	扌廿日
眠	目巳七
途	之亼木
鄂	口口一丂阝
捅	扌龴用
叢	业半耳又
禾	禾
磁	石䒑幺幺
錶	金丰衤
沃	氵丿大
屢	尸婁
辯	辛言辛
肚	月土
哀	衣口
浸	氵彐冖又
柄	木一冂人
跪	足𠂊厂卩
攬	扌臣𠂉丶四見
攬	扌臣𠂉一四見
輯	車口耳
瓷	二欠瓦
瓷	冫欠瓦
澀	氵刀丶刀丶止止
踹	足山而
凸	圍冂
瑜	王亼月刂
瑜	王亼月巛
磅	石亠八冖方
豈	山一口䒑
瀉	氵宀臼勹火
遼	之一火日小
豎	臣又一口䒑
宴	宀日女
堪	土甘匚儿
堪	土甘匚八
擱	扌門夂口
麟	鹿米夕㐄
祿	示彑水
翟	习习隹
仗	亻一乂
崩	山月月
醜	酉鬼
厲	厂艹日冂厶
革	革
莪	艹手戈
憲	宀丰四心
遺	之中一貝
聘	耳由丂
喚	口𠂊冂八大
閘	門甲
刊	干刂
裁	十戈衣
郁	𠂇月阝
逝	之扌斤
際	阝䏑又示
狄	犭火
誌	言士心
塌	土日习习
崖	山厂土土
廉	广禾禾彐
婉	女宀夕卩
攀	木乂乂木大手
獅	犭丿㠯一巾
喘	口山而
氫	气一巛工
氮	气火火
鞍	革宀女
竈	穴土黽
竇	穴士四貝
墳	土十艹貝
巫	工人人
虞	虎口一大
虞	虎口乚大
虞	虎口乚廾
沁	氵心
瑟	王王弋八
揪	扌禾火
棵	木田木
閆	門三
拐	扌口力
拐	扌口刀
築	竹工凡木
癮	疒阝爪工彐心
剝	彑水刂
披	扌皮
削	小月刂
籃	竹臣𠂉丶皿
籃	竹臣𠂉一皿
悠	亻丨夂心
悠	亻丨攵心
睿	卜冖一八人目
甯	宀心用
凹	圍凵
葬	艹一夕匕廾
咦	口大弓
瞪	目癶一口䒑
詹	𠂊厂八言
侃	亻口川
授	扌爪冖又
卸	午止卩
頌	八厶頁
慈	䒑幺幺心
闊	門氵舌
纖	糸人人戈非一
棗	木冂木冂
瞄	目艹田
婭	女亞
駱	馬夂口
馳	馬也
鞭	革亻一日乂
楞	木四方
兌	八口儿
危	𠂊厂卩
襲	龍衣
泊	氵白
喉	口亻コ矢
溶	氵穴人口
撫	扌𠂉廿廿火
媛	女爪一𠂇又
拎	扌亼卩
拎	扌亼龴
察	宀䏑又示
駿	馬厶八夂
繪	糸亼四日
黴	行山一四土火攵
黴	行山一田土火攵
鈞	金勹冫
鈞	金勹二
憐	心米夕㐄
昆	日匕匕
禹	丿口冂厶
娥	女手戈
醇	酉亠口子
橙	木癶一口䒑
辨	辛刂辛
暮	艹日大日
祕	示弋八
薪	艹立木斤
煥	火𠂊冂八大
巢	巛田木
鉀	金甲
脾	月鬼十
淵	氵爿一爿
愚	日冂厶心
蜀	四勹虫
裹	衣田木
藕	艹耒日冂厶
滕	月半水
劈	尸口辛刀
堤	土日一止
拱	扌艹廾
夸	大一丂
夸	大丂一
傍	亻亠八冖方
燥	火口口口木
綫	糸戈戈
漁	氵魚
茜	艹西
允	厶儿
杏	木口
芒	艹亡
畔	田半
豹	豸勹丶
澄	氵癶一口䒑
冥	冖日亠八
媒	女甘木
燦	火卜夕又米
酥	酉禾
垮	土大一丂
垮	土大丂一
枯	木十口
軌	車九
塑	䒑屮月土
卜	卜
構	木甘冂土
茅	艹予丿
鉅	金匚コ
慾	八人口欠心
搏	扌甫寸
鑄	金士㇕工一口寸
沐	氵木
豫	予召豕
蒜	艹示示
淩	氵土儿夂
淩	氵土八夂
雀	小隹
鈦	金大丶
亨	亠口了
詳	言羊
腐	广亻寸䏑
皓	白牛口
央	冂大
氟	气弓刂
冤	冖召儿丶
据	扌尸十口
浙	氵扌斤
瑋	王㐄口㐄
栓	木人王
梳	木亠厶川
冀	北田艹廾
叄	厶厶厶人三
輩	非車
筱	竹亻丨夂
筱	竹亻丨攵
冉	冂土
餡	食𠂊臼
彤	冊丶彡
奕	大八大
卑	鬼十
誓	扌斤言
蜂	虫夂丰
勺	勹丶
迅	之乙十
虫	虫
恥	耳心
匹	匚儿
曦	日羊禾戈丂
仰	亻匕卩
煞	𠂊彐攵火
羞	羊彐丨
注	氵丶王
嫂	女臼丨又
瞳	目立田土
黛	亻弋四土火
黛	亻弋田土火
妾	立女
拂	扌弓刂
挨	扌厶矢
泄	氵廿乚
綱	糸冂䒑山
茨	艹二欠
茨	艹冫欠
夷	大弓
慎	心十目廾
汽	氵气
婕	女一彐止
恭	艹廾心
弊	巾⺍攵廾
屌	尸口巾
摳	扌匚口口口
貳	弋二貝
旦	日一
涂	氵亼木
氯	气彐水
祁	示阝
蠟	虫巛圍乂巛
乍	𠂉匕
孰	亠口子丸
耕	耒二刂
飆	犬犬犬風
稻	禾爪臼
屠	尸耂
綺	糸大丁口
荊	艹一廾刂
桿	木日干
笛	竹由
捕	扌甫
蕊	艹心心心
喪	土口口衤
盪	氵日一勿皿
氨	气宀女
愣	心四方
幺	幺
瀾	氵門木四
瀾	氵門木日
悔	心𠂉母
敦	亠口子攵
葵	艹癶一大
煒	火㐄口㐄
磕	石土厶皿
顫	亠圍口日一頁
閩	門虫
渴	氵日勹亡
曝	日日艹廾水
閔	門文
撇	扌巾⺍攵
梗	木一日乂
絡	糸夂口
貫	母貝
蔚	艹尸示寸
翅	十又习习
估	亻十口
鎂	金羊大
復	行𠂉日夂
瓣	辛瓜辛
濫	氵臣𠂉丶皿
濫	氵臣𠂉一皿
況	氵口儿
淮	氵隹
陀	阝宀匕
莖	艹一巛工
勳	千四二火力
惑	戈口一心
簾	竹广禾禾彐
巡	之巛
墩	土亠口子攵
徽	行山一糸攵
謹	言艹口丰
謹	言廿口丰
脹	月長
噓	口虎丘
瞞	目廿巾人人
娛	女口乚大
蓄	艹亠幺田
梓	木辛
匪	匚非
昕	日斤
濺	氵貝戈戈
敘	亼木攵
鑑	金臣𠂉丶皿
鑑	金臣𠂉一皿
溢	氵䒑八皿
彌	弓一八巾乂乂乂乂
覓	爪見
寇	宀一兀卜又
佟	亻夂冫
獵	犭巛圍乂巛
滄	氵人户口
葷	艹冖車
蓬	艹之夂丰
薦	艹鹿一乚火
硫	石亠厶川
俏	亻小月
迫	之白
貌	豸白儿
弔	丨弓
舜	爪冖夕㐄
炳	火一冂人
茄	艹力口
頤	臣頁
訣	言㇕大
廚	广士口䒑寸
炭	山𠂇火
綿	糸白巾
搗	扌鳥山
萱	艹宀二日
岡	冂䒑山
挂	扌土土
掀	扌斤欠
誘	言禾㇕丿
翰	十日十人习习
睜	目爪尹
撓	扌土土土兀
掩	扌大申
蹬	足癶一口䒑
泳	氵丶水
玫	王攵
椅	木大丁口
鈺	金王丶
遜	之子丿糸
甄	西土瓦
侍	亻土寸
抑	扌匕卩
啞	口亞
敖	士方攵
敖	土方攵
敖	丰力攵
酮	酉冂一口
毫	亠口冖毛
侵	亻彐冖又
妥	爪女
覽	臣𠂉丶四見
覽	臣𠂉一四見
概	木艮旡
貢	工貝
呦	口幺力
援	扌爪一𠂇又
昔	廿日
晾	日亠口小
逮	之尹⺍
卒	亠人人十
鬆	長彡木八厶
捆	扌圍木
厭	厂日月犬
峽	山大人人
彷	行方
寢	宀爿彐冖又
菱	艹土儿夂
菱	艹土八夂
梯	木弋弓
僑	亻丿大口冂口
籽	米子
腕	月宀夕卩
挫	扌人人土
膝	月木人水
嗦	口十冖糸
璇	王方𠂉足
眨	目丿之
循	行𠂆十目
臀	尸艹廾殳月
矛	予丿
努	女又力
黔	四土火亼㇕
黔	田土火亼㇕
乏	丿之
魅	鬼二木
徹	行亠厶月攵
凶	乂凵
胺	月宀女
廈	广頁夂
掘	扌尸屮凵
茗	艹夕口
絨	糸戈𠂇
璐	王足夂口
擾	扌一白冖心夂
襯	衤立木見
雌	止匕隹
旱	日干
掰	手八刀手
伽	亻力口
蛙	虫土土
雕	用口隹
嬰	貝貝女
痣	疒士心
譽	臼一乚丨廾言
跡	足大八
廂	广木目
汀	氵丁
隋	阝𠂇工月
緒	糸耂
蘊	艹糸圍人皿
勻	勹二
祛	示土厶
芙	艹夫
棲	木一尹女
刁	㇕一
瑛	王艹冂大
禽	人亠乂凵冂厶
腺	月白水
迦	之力口
矯	矢丿大口冂口
欺	甘廾欠
杉	木彡
党	小冖口儿
竅	穴白方攵
鑲	金衣口口甘
緯	糸㐄口㐄
曏	日乚凵丶艮阝
曏	日乚凵艮阝
繆	糸习习人彡
玖	王𠂊丶
肆	長彐キ
悉	釆心
掂	扌广卜口
菁	艹丰月
鎳	金自木
冶	冫厶口
絆	糸半
嘔	口匚口口口
遣	之中一㠯
岑	山亼㇕
皖	白宀一兀
糕	米羊火
斐	非文
閤	門亼口
釀	酉衣口口甘
彙	彑冖田木
址	土止
蘸	艹酉隹火
茵	艹圍大
簿	竹氵甫寸
旬	勹日
丈	一乂
咸	戊一口
呸	口不一
胤	儿幺月
摻	扌厶厶厶人彡
蹤	足行人人止
婁	婁
鎚	金之丿㠯
桓	木二日
碘	石冊廾
瞅	目禾火
廊	广丶艮阝
焰	火𠂊臼
壘	田田田土
燁	火華
淳	氵亠口子
畏	田衤
屑	尸小月
酯	酉匕日
覃	西日十
嵌	山甘欠
販	貝厂又
販	貝𠂆又
泣	氵立
嗆	口人户口
眾	四亻
袍	衤勹巳
菴	艹大申
僵	亻三田田
饞	食召匕匕召儿丶
沫	氵一木
滯	氵廿儿冖巾
臻	至丰禾
眺	目儿⺍
寂	宀上小又
醣	酉广尹口
晏	日宀女
秤	禾干八
嗚	口烏
蘿	艹四糸隹
誅	言𠂉木
瑾	王艹口丰
瑾	王廿口丰
藻	艹氵口口口木
螺	虫田糸
錠	金宀一止
診	言人彡
恤	心丿皿
污	氵一丂
涯	氵厂土土
滋	氵䒑幺幺
蘆	艹虎田皿
嗜	口耂匕日
貿	卯貝
療	疒一火日小
滲	氵厶厶厶人彡
瀝	氵厂禾禾止
陡	阝走
栗	西木
筍	竹勹日
朔	䒑屮月
淇	氵甘廾
捻	扌亼㇕心
勃	十冖子力
矩	矢匚コ
沽	氵十口
淤	氵方人冫
描	扌艹田
膚	虎田月
契	丰刀大
靳	革斤
祠	示㇕一口
陝	阝大人人
鞏	工凡革
峻	山厶八夂
稠	禾用口
爵	爪四艮寸
秉	禾彐
刨	勹巳刂
雍	亠乚凵隹
群	尹口羊
麵	木人人夂頁圍
盞	戈戈皿
役	行殳
烙	火夂口
灾	宀火
强	弓口虫
痘	疒一口䒑
髓	骨之𠂇工月
嫣	女一止一乚火
募	艹日大力
苟	艹勹口
析	木斤
篩	竹丿㠯一巾
魁	鬼冫十
斥	斤丶
棕	木宀示
匡	匚王
倦	亻半卩
疆	弓土三田田
蔓	艹日四又
蔓	艹冖二四又
樺	木華
牟	厶牛
芷	艹止
霆	雨廴工一
霆	雨廴丿士
霆	雨廴亻土
蠶	旡旡日虫虫
嘰	口幺幺戈人
靴	革亻匕
慮	虎田心
眸	目厶牛
烟	火圍大
惱	心巛囟
巾	巾
殊	一夕𠂉木
叮	口丁
晟	日戊㇕
艇	舟廴工一
艇	舟廴丿士
艇	舟廴亻土
熔	火穴人口
裘	十⺍丶衣
芹	艹斤
儘	亻尹一火皿
寡	宀頁刀
擲	扌八酉大阝
蔔	艹勹一口田
硪	石手戈
迥	之冂口
巖	山口口厂丁耳攵
巖	山口口厂㇕耳攵
瞬	目爪冖夕㐄
邑	口巴
〇	口
鉻	金夂口
榕	木穴人口
庸	广尹用
渾	氵冖車
棠	小冖口木
仨	亻三
祺	示甘廾
紡	糸方
蝕	食虫
窺	穴夫見
埠	土丿㠯十
酚	酉八刀
奮	大隹田
剎	乂木丶刂
剎	乂十儿丶刂
濁	氵四勹虫
茬	艹一亻土
濾	氵虎田心
珂	王丁口
嗅	口自犬
簫	竹尹爿一爿
佰	亻一白
滇	氵十目廾
滇	氵匕目廾
寅	宀一由八
婧	女丰月
姦	女女女
梵	木木凡
蛾	虫手戈
慰	尸示寸心
履	尸行𠂉日夂
駛	馬口乂
宛	宀夕卩
襪	衤艹四戈人
嫖	女西示
綸	糸亼冊
礙	石匕矢龴足
肽	月大丶
獄	犭言犬
闢	門尸口辛
歎	廿口夫欠
歎	艹口夫欠
蟬	虫口口甲一
涮	氵尸巾刂
督	上小又目
衍	行氵
違	之㐄口㐄
絞	糸亠八乂
廿	廿
摁	扌圍大心
劣	小丿力
銜	行金
祈	示斤
搵	扌圍人皿
尅	十口儿寸
貶	貝丿之
魄	白鬼
崽	山田心
斧	八乂斤
裔	衣冂儿口
裔	衣冂八口
湛	氵甘匚儿
湛	氵甘匚八
琛	王冖儿木
琛	王冖八木
淌	氵小冂口
簇	竹方𠂉矢
償	亻小冖口貝
沛	氵一巾
澗	氵門日
殤	一夕𠂉日一勿
掠	扌亠口小
崎	山大丁口
贛	立日十夂工貝
蕩	艹氵日一勿
菇	艹女十口
砌	石七刀
眯	目米
闌	門木四
闌	門木日
嬲	田力女田力
辱	辰寸
匠	匚斤
肘	月寸
淹	氵大申
洽	氵亼口
溟	氵冖日亠八
諗	言亼㇕心
究	穴九
慼	戊上小心
矢	矢
蟻	虫羊手戈
澈	氵亠厶月攵
葦	艹㐄口㐄
瞥	巾⺍攵目
崑	山日匕匕
墮	阝𠂇工月土
輓	車召儿
鴿	亼口鳥
錘	金千艹二
懼	心目目隹
坨	土宀匕
椰	木耳阝
梢	木小月
嘟	口耂阝
瀟	氵艹尹爿一爿
障	阝立日十
霄	雨小月
疇	田士㇕工一口寸
揣	扌山而
槐	木鬼
粟	西米
唆	口厶八夂
誦	言龴用
綜	糸宀示
詢	言勹日
劃	彐キ田一刂
札	木乚
駁	馬乂乂
拴	扌人王
攏	扌龍
聳	行人人止耳
燭	火四勹虫
襖	衤宀米大
臘	月巛圍乂巛
吏	一口乂
堰	土匚日女
棺	木宀㠯
腥	月日生
胞	月勹巳
羨	羊氵欠
韶	立日召
阜	丿㠯十
剖	立口刂
羹	羊火羊大
剃	弋弓刂
寓	宀日冂厶
峪	山八人口
煜	火日立
竊	穴釆卜冂人冂厶
撩	扌一火日小
扳	扌厂又
扳	扌𠂆又
桔	木士口
轄	車宀丰口
臧	戈爿臣
喀	口宀夂口
妄	亡女
陌	阝一白
弧	弓瓜
弩	女又弓
撰	扌巳巳艹廾
瞿	目目隹
卞	亠卜
蛤	虫亼口
襄	衣口口甘
肅	尹爿一爿
擒	扌人亠乂凵冂厶
哨	口小月
鑿	业半臼殳金
皂	白七
佘	人示
鋸	金尸十口
汞	工水
芭	艹巴
膿	月曲辰
懿	士冖一口䒑二欠心
懿	士冖一口䒑冫欠心
蔭	艹阝亼㇕二厶
椒	木上小又
戎	戈𠂇
肋	月力
翎	亼卩习习
翎	亼龴习习
煌	火白王
錐	金隹
疤	疒巴
瀚	氵十日十人习习
闕	門䒑屮欠
絹	糸口月
僱	亻户隹
泓	氵弓厶
昧	日二木
柒	氵七木
棧	木戈戈
硯	石見
錳	金子皿
旨	匕日
鱗	魚米夕㐄
巳	巳
辜	十口辛
筐	竹匚王
膊	月甫寸
遵	之八酉寸
摺	扌习习白
輥	車日匕匕
嗒	口艹亼口
剁	几木刂
愧	心鬼
拙	扌屮凵
彆	巾⺍攵弓
竿	竹干
鈔	金小丿
鏟	金立丿生
驛	馬四土半
鱉	巾⺍攵魚
稜	禾土儿夂
稜	禾土八夂
憤	心十艹貝
綽	糸卜日十
鶯	火火冖鳥
緻	糸至攵
圭	土土
塚	土冖豕
甸	勹田
衷	衣中
燜	火門心
脊	⺍人月
憨	丁耳攵心
憨	㇕耳攵心
搽	扌艹人木
捶	扌千艹二
勵	厂艹日冂厶力
毓	𠂉母亠厶川
苔	艹厶口
鉗	金甘
鉢	金木一
奸	女干
坂	土厂又
坂	土𠂆又
淼	水水水
黏	禾人水卜口
縷	糸婁
甭	不用
瞟	目西示
舅	臼田力
錚	金爪尹
錚	金𠂊尹
阪	阝厂又
阪	阝𠂆又
恕	女口心
轎	車丿大口冂口
啼	口亠八冖巾
繭	艹冂糸丨虫
鬱	午凵木木冖乂凵匕彡
曠	日广廿由八
睹	目耂
禿	禾儿
諦	言亠八冖巾
疲	疒皮
褪	衤之艮
鞠	革勹米
釉	釆由
彰	立日十彡
綴	糸又又又又
軋	車乚
酬	酉⺍川
橘	木予丿冂儿口
橘	木予丿冂八口
啪	口扌白
睛	目丰月
斂	亼口口人人攵
遁	之𠂆十目
晝	彐キ日一
殲	一夕人人戈非一
樸	木业半大
哆	口夕夕
窟	穴尸屮凵
鈍	金丿屮
鈍	金一屮
垢	土𠂆一口
愿	厂白小心
奚	爪幺大
誼	言宀且
緋	糸非
紛	糸八刀
褚	衤耂
腮	月田心
枉	木王
旳	日勹丶
鍍	金广廿又
涓	氵口月
嗟	口羊工
蠱	虫虫虫皿
笙	竹生
沸	氵弓刂
妓	女十又
儉	亻亼口口人人
猿	犭土口衤
漠	氵艹日大
撬	扌毛毛毛
巍	山禾女鬼
鉑	金白
漾	氵羊丶水
擎	艹勹口攵手
詐	言𠂉匕
絃	糸亠幺
靶	革巴
鴉	牙鳥
俐	亻禾刂
胚	月不一
楷	木匕匕白
侶	亻口丿口
迭	之手丶
詔	言召
嗣	口冊㇕一口
嵩	山亠口冂口
驕	馬丿大口冂口
蠅	虫黽
蹄	足亠八冖巾
穫	禾艹隹又
潰	氵中一貝
褐	衤日勹亡
丞	㇕水一
芮	艹冂人
梭	木厶八夂
瘡	疒人户口
槓	木工貝
唷	口亠厶月
曜	日习习隹
鯨	魚亠口小
灝	氵日亠口小頁
鎊	金亠八冖方
畜	亠幺田
廬	广虎田皿
砼	石人工
粽	米宀示
韌	㐄口㐄刀丶
囉	口四糸隹
唑	口人人土
鋰	金田土
鸞	言糸糸鳥
鈾	金由
宵	宀小月
榆	木亼月刂
嚷	口衣口口甘
釵	金又丶
焱	火火火
絮	女口糸
戊	戊
鄔	烏阝
剷	立丿生刂
罕	冖儿干
罕	冖八干
欒	言糸糸木
糾	糸凵
駝	馬宀匕
叩	口卩
箏	竹爪尹
俯	亻广亻寸
瀑	氵日艹廾水
濕	氵日幺幺火
肇	户攵彐キ
窪	穴氵土土
毋	母丿
摞	扌田糸
暇	日尸二コ又
岐	山十又
睬	目爪木
郊	亠八乂阝
璧	尸口辛王丶
挾	扌大人人
捎	扌小月
嶼	山臼一乚丨廾
汶	氵文
糸	糸
嘀	口亠八冂十口
斃	巾⺍攵一夕匕
犁	禾刂牛
怔	心一止
焚	木木火
恁	亻工一心
恁	亻丿士心
鷗	匚口口口鳥
癖	疒尸口辛
灼	火勹丶
孽	艹丿㠯辛子
岱	亻弋山
麓	木木鹿
匙	日一止匕
嚎	口亠口冖豕
爻	乂乂
鏢	金西示
涇	氵一巛工
珏	王王丶
摧	扌山隹
械	木戈廾
乞	𠂉乙
卯	卯
凋	冫用口
蕙	艹一日厶心
噗	口业半大
硒	石西
嗔	口十目廾
嗔	口匕目廾
卟	口卜
筠	竹土勹冫
筠	竹土勹二
諧	言匕匕白
咔	口上卜
喧	口宀二日
癲	疒十目廾頁
癲	疒匕目廾頁
汎	氵凡
瓢	西示瓜
嚕	口魚日
裳	小冖口衣
釗	金刂
謊	言艹亡川
晤	日二乂口
晤	日工㇕口
竭	立日勹亡
妨	女方
玻	王皮
聾	龍耳
宸	宀辰
擅	扌亠圍口日一
蔘	艹厶厶厶人彡
諫	言木四
烹	亠口了火
卉	十艹
綾	糸土儿夂
綾	糸土八夂
括	扌舌
檐	木𠂊厂八言
漬	氵丰貝
戟	十日十戈
韜	㐄口㐄爪臼
尸	尸
椎	木隹
恬	心舌
胥	足月
檀	木亠圍口日一
坯	土不一
葡	艹勹甫
仄	厂人
噯	口爪冖心夂
溴	氵自犬
縛	糸甫寸
姝	女𠂉木
嬸	女宀釆田
塢	土烏
壙	土广廿由八
伙	亻火
蠍	虫日勹亡欠
暱	日匚艹𠂇口
垣	土二日
拘	扌勹口
呱	口瓜
昱	日立
篤	竹馬
箍	竹扌匚巾
鳩	九鳥
噁	口亞心
躁	足口口口木
噬	口竹工人人
鎢	金烏
孚	爪子
穀	士冖一禾殳
玥	王月
蓓	艹亻立口
蛆	虫且
囚	圍人
癱	疒廿口夫隹
癱	疒艹口夫隹
鞘	革小月
瀨	氵木口𠂊貝
瀨	氵木口刀貝
滷	氵卜圍乂
匣	匚甲
鉬	金目
銹	金禾㇕丿
凳	癶一口䒑几
隙	阝小日小
娣	女弋弓
驟	馬耳又亻
莞	艹宀一兀
曆	厂禾禾日
躥	足穴臼釆
銨	金宀女
荃	艹人王
伶	亻亼卩
伶	亻亼龴
謠	言䏑午凵
璽	一八巾乂乂乂乂王丶
拭	扌弋工
醃	酉大申
墅	田土予土
釩	金凡
懵	心艹四冖目
苷	艹甘
碾	石尸廿衤
雋	隹冂凵
禧	示士口䒑口
囡	圍女
鷺	足夂口鳥
鵑	口月鳥
脅	力力力月
榨	木穴𠂉匕
黯	四土火立日
黯	田土火立日
侖	亼冊
荼	艹亼木
苞	艹勹巳
戚	戊上小
曄	日華
饃	食艹日大
頒	八刀頁
倘	亻小冂口
怯	心土厶
淪	氵亼冊
礁	石隹火
睏	目圍木
瞻	目𠂊厂八言
躬	身弓
餌	食耳
脖	月十冖子
襟	衤木木示
尉	尸示寸
絳	糸夂㐄
軼	車手丶
亥	亠凵人
屄	尸穴
蘋	艹止癶頁
尐	小丶
肢	月十又
悄	心小月
紐	糸彐丨
閹	門大申
弋	弋
厘	厂田土
貯	貝宀丁
僕	亻业半大
憎	心八四日
憎	心八田日
禎	示卜貝
隴	阝龍
緬	糸頁圍
頰	大人人頁
砷	石申
糙	米之牛口
炯	火冂口
莘	艹辛
盔	𠂇火皿
睦	目土儿土
睦	目土八土
仟	亻千
炕	火亠几
渦	氵咼
鬢	長彡宀一癶貝
艷	丰丰山一口䒑𠂊巴
荔	艹力力力
嗷	口士方攵
嗷	口土方攵
嗷	口丰力攵
盅	中皿
籲	竹亼口口口冊頁
鯊	氵小丿魚
藩	艹氵釆田
楨	木卜貝
奢	大耂
尬	尤亻八
趾	足止
贖	貝士四貝
瘀	疒方人冫
悼	心卜日十
臍	月齊
抿	扌巳七
憾	心戊一口心
愷	心山一口䒑
孓	了丶
滌	氵亻丨夂木
滌	氵亻丨攵木
浣	氵宀一兀
兀	兀
蹟	足丰貝
囿	圍𠂇月
嶽	山犭言犬
稚	禾隹
褒	衣亻口木
痔	疒土寸
烘	火艹廾
渭	氵田月
嘻	口士口䒑口
錨	金艹田
鍛	金厂三殳
喏	口艹𠂇口
町	田丁
麒	鹿甘廾
熄	火自心
烯	火乂𠂇巾
艮	艮
珉	王巳七
捋	扌爪寸
薯	艹四耂
禦	行午止卩示
蕉	艹隹火
荀	艹勹日
逍	之小月
冼	冫牛儿
泪	氵目
拗	扌幺力
檯	木士口冖至
轍	車亠厶月攵
鵰	用口鳥
毯	毛火火
鐸	金四土半
邸	氏一阝
邸	氏丶阝
柵	木冊
炙	䏑火
倭	亻禾女
翊	立习习
熾	火立日戈
馱	馬大
莽	艹犬廾
莽	艹大廾
笠	竹立
勉	召儿力
亢	亠几
羌	羊儿
璋	王立日十
毆	匚口口口殳
咚	口夂冫
癟	疒自亼冊
槳	爿䏑寸木
恪	心夂口
涌	氵龴用
妒	女户
醯	酉亠厶川皿
圩	土丁一
噹	口小冖口田
暑	日耂
軀	身匚口口口
鈷	金十口
疫	疒殳
歉	禾禾彐欠
汐	氵夕
績	心丰貝
樟	木立日十
峩	山手戈
錒	金阝丁口
豁	宀丰口八人口
窖	穴牛口
脉	月丶水
启	户口
驥	馬北田艹廾
扭	扌彐丨
胰	月大弓
梟	鳥木
泗	氵四
邇	之一八巾乂乂乂乂
啟	户口攵
帘	穴巾
隅	阝日冂厶
葆	艹亻口木
岔	八刀山
歆	立日欠
禰	示一八巾乂乂乂乂
弛	弓也
秘	禾弋八
渚	氵耂
纜	糸臣𠂉丶四見
纜	糸臣𠂉一四見
枴	木口刀
畀	田廾
鑼	金四糸隹
廁	广貝刂
撼	扌戊一口心
雛	勹屮勹屮隹
痞	疒不口
瘟	疒日皿
樽	木八酉寸
崢	山爪尹
颳	風舌
澇	氵火火冖力
歧	止十又
椿	木丰日
确	石𠂊用
咀	口且
箋	竹戈戈
价	亻亻八
寮	宀一火日小
緹	糸日一止
繃	糸山月月
蒿	艹亠口冂口
醛	酉艹人王
肏	人䏑
譟	言口口口木
悍	心日干
嬋	女口口甲一
駭	馬亠凵人
碁	甘廾石
硼	石月月
啤	口鬼十
壬	工一
壬	丿士
鄺	广廿由八阝
叛	半厂又
叛	半𠂆又
浚	氵厶八夂
獒	士方攵犬
獒	土方攵犬
獒	丰力攵犬
捌	扌口力刂
霽	雨齊
嘮	口火火冖力
鎘	金一口冂八丁
勘	甘匚儿力
勘	甘匚八力
剌	木口刂
樵	木隹火
啄	口豕
倡	亻日日
肛	月工
糜	广木木米
糜	广十儿十儿米
漪	氵犭大丁口
迴	之圍口
駒	馬勹口
瑕	王尸二コ又
蔽	艹巾⺍攵
鐳	金雨田
糯	米雨而
茫	艹氵亡
噎	口士冖一口䒑
飼	食㇕一口
狹	犭大人人
凰	几白王
溺	氵弓冫弓冫
寰	宀四一口衤
璞	王业半大
霓	雨臼儿
醚	酉之米
硝	石小月
囤	圍丿屮
囤	圍一屮
吭	口亠几
靡	广木木非
靡	广十儿十儿非
厥	厂䒑屮欠
凜	冫亠圍口禾
跺	足几木
沓	水日
忻	心斤
遛	之卯田
萃	艹亠人人十
氈	亠圍口日一毛
埔	土甫
扼	扌厂卩
吱	口十又
竺	竹二
綢	糸用口
霏	雨非
蛟	虫亠八乂
圃	圍甫
晗	日亼㇕口
鉉	金亠幺
鋤	金且力
誕	言廴丿止
泠	氵亼卩
泠	氵亼龴
瘸	疒力口䏑
琢	王豕
酉	酉
棘	木冂木冂
蚌	虫丰
虜	虎田力
吋	口寸
夥	田木夕夕
譁	言華
辮	辛糸辛
疣	疒尤
恍	心小兀
貽	貝厶口
糠	米广尹⺍
渺	氵目小丿
洙	氵𠂉木
瀛	氵亡口月女凡
祀	示巳
瓏	王龍
琅	王丶艮
攥	扌竹目大糸
苛	艹丁口
苓	艹亼卩
苓	艹亼龴
丕	不一
唬	口虎
夭	丿大
腌	月大申
姍	女冊
橡	木召豕
嗄	口頁夂
眩	目亠幺
弈	大八廾
珞	王夂口
拈	扌卜口
茸	艹耳
倔	亻尸屮凵
諜	言廿乚木
喆	士口士口
艱	廿口夫艮
艱	艹口夫艮
貂	豸召
諒	言亠口小
丰	丰
耙	耒巴
跋	足犬丿
跋	足犬㇕
踱	足广廿又
叭	口八
恢	心𠂇火
彝	彑米糸廾
綰	糸宀㠯
扽	扌丿屮
扽	扌一屮
磯	石糸糸戈人
旌	方𠂉生
濮	氵亻业半大
孜	子攵
琨	王日匕匕
琰	王火火
踐	足戈戈
舵	舟宀匕
廝	广甘廾斤
寐	宀爿二木
璃	王亠乂凵冂厶
荻	艹犭火
孬	不女子
懈	心𠂊用刀牛
漕	氵一曲日
磐	舟殳石
宦	宀臣
撅	扌厂䒑屮欠
櫟	木白幺幺木
罡	四一止
漱	氵木口欠
櫥	木广士口䒑寸
諱	言㐄口㐄
庶	广廿火
癬	疒魚羊
馭	馬又
掄	扌亼冊
釜	八乂王八
焯	火卜日十
熵	火亠八冂儿口
熵	火亠八冂八口
騫	宀甘八馬
釐	二木攵厂田土
挎	扌大一丂
挎	扌大丂一
茉	艹一木
隸	木示尹⺍
匾	匚户冊
筑	竹工凡
膳	月羊䒑口
濡	氵雨而
蕪	艹𠂉廿廿火
鎬	金亠口冂口
痹	疒田廾
恃	心土寸
淞	氵木八厶
頹	禾儿頁
鋇	金貝
舀	爪臼
閑	門木
搔	扌又冫虫
搔	扌又丶虫
矇	目艹冖一豕
縈	火火冖糸
嬪	女宀一癶貝
梧	木二乂口
梧	木工㇕口
匝	匚巾
哌	口𠂆亻
羈	四革馬
屹	山𠂉乙
侑	亻𠂇月
頃	匕頁
鯉	魚田土
灸	𠂊丶火
甦	一日乂生
熹	士口䒑火
鵲	廿日鳥
鑰	金亼口口口冊
焙	火立口
蹈	足爪臼
牡	牛土
秧	禾冂大
飢	食几
狸	犭田土
訶	言丁口
訥	言冂人
沼	氵召
襠	衤小冖口田
夯	大力
毗	田匕匕
慫	行人人止心
懲	行山一王攵心
炬	火匚コ
逞	之口王
逞	之口亻土
曖	日爪冖心夂
簧	竹廿由八
脲	月尸水
鰭	魚耂匕日
窘	穴尹口
赦	土火攵
蔫	艹一止一乚火
柚	木由
煨	火田衤
溯	氵䒑屮月
宙	宀由
薹	艹士口冖至
斟	甘匚儿冫十
斟	甘匚八冫十
柑	木甘
匿	匚艹𠂇口
剔	日勿刂
崴	山戊一女
胯	月大一丂
胯	月大丂一
眷	半目
癸	癶一大
緞	糸厂三殳
馴	馬川
蟎	虫廿巾人人
顱	虎田皿頁
嘲	口十日十月
噤	口木木示
弒	乂木丶弋工
弒	乂十儿丶弋工
諭	言亼月刂
諭	言亼月巛
謬	言习习人彡
甕	亠乚凵隹瓦
噩	王口口口口
鬚	長彡彡頁
蟒	虫艹犬廾
蟒	虫艹大廾
偵	亻卜貝
鎧	金山一口䒑
攆	扌夫夫車
巔	山十目廾頁
燮	言火火又
汲	氵𠂊又
筷	竹心㇕大
輿	臼車廾
侄	亻至
詭	言𠂊厂卩
滔	氵爪臼
銑	金牛儿
姣	女亠八乂
丐	下乚
檸	木宀心皿丁
硃	石𠂉木
戌	戊一
敝	巾⺍攵
壟	龍土
諮	言二欠口
諮	言冫欠口
疹	疒人彡
炊	火欠
涕	氵弋弓
瑣	王小貝
摹	艹日大手
樞	木匚口口口
覈	西白方攵
杵	木午
棣	木尹⺍
羚	羊亼卩
羚	羊亼龴
渤	氵十冖子力
蝨	乙十虫虫
墟	土虎业
墟	土虎丘
柿	木亠巾
烷	火宀一兀
綏	糸爪女
薔	艹土人人圍口
蹙	戊上小足
噪	口口口口木
頑	一兀頁
璟	王日亠口小
氖	气㇕丿
攸	亻丨攵
帛	白巾
膨	月士口䒑彡
涐	氵手戈
甬	龴用
琉	王亠厶川
抒	扌予
薊	艹魚刂
酌	酉勹丶
榭	木身寸
鐺	金小冖口田
爍	火白幺幺木
沅	氵一兀
濠	氵亠口冖豕
闇	門立日
嬉	女士口䒑口
殖	一夕十目
珀	王白
眶	目匚王
稼	禾宀豕
錛	金大十艹
咎	夂卜口
潞	氵足夂口
絢	糸勹日
莓	艹𠂉母
嘈	口一曲日
馥	禾日𠂉日夂
皋	白大十
粹	米亠人人十
瀅	氵火火冖王丶
祗	示氏一
祗	示氏丶
穢	禾止戊一癶
褂	衤土土卜
娼	女日日
鰲	士方攵魚
鰲	土方攵魚
鰲	丰力攵魚
琱	王用口
鳶	弋鳥
叟	臼丨又
墾	豸艮土
廓	广亠口子阝
弼	弓一白弓
珈	王力口
旻	日文
翡	非习习
曳	申丿
偕	亻匕匕白
諶	言甘匚儿
諶	言甘匚八
羲	羊禾戈丂
汾	氵八刀
陂	阝皮
藺	艹門隹
軾	車弋工
蛹	虫龴用
丿	丿
儷	亻一冂丶一冂丶鹿
僦	亻亠口小尤
郅	至阝
啖	口火火
籬	竹亠乂凵冂厶隹
豚	月豕
湄	氵尸目
熨	尸示寸火
犀	尸水牛
珺	王尹口
咂	口匚巾
釹	金女
糗	米自犬
摯	土半丸手
騏	馬甘廾
吡	口匕匕
冕	冖二召儿
頜	亼口頁
褶	衤习习白
巿	一巾
垛	土几木
髻	長彡士口
擂	扌雨田
芊	艹千
檬	木艹冖一豕
砬	石立
咕	口十口
嘶	口甘廾斤
昀	日勹冫
昀	日勹二
卹	丿皿卩
疝	疒山
尻	尸九
孑	了一
坳	土幺力
薈	艹亼四日
槌	木之丿㠯
吮	口厶儿
厂	厂
芋	艹丁一
萎	艹禾女
榻	木日习习
嗡	口八厶习习
漣	氵之車
妤	女予
墒	土亠八冂儿口
墒	土亠八冂八口
瑄	王宀二日
隼	隹十
訟	言八厶
燬	火臼工殳
烴	火一巛工
巒	言糸糸山
吠	口犬
囑	口尸水四勹虫
幡	巾釆田
篷	竹之夂丰
伢	亻牙
仂	亻力
沂	氵斤
尕	㇕丿小
聆	耳亼卩
聆	耳亼龴
騁	馬由丂
嗑	口土厶皿
稟	亠圍口禾
漳	氵立日十
沱	氵宀匕
卅	一川
碌	石彐水
偈	亻日勹亡
蒽	艹圍大心
颱	風厶口
燴	火亼四日
冪	冖艹日大巾
怠	厶口心
擄	扌虎田力
杠	木工
砰	石干八
鹵	卜圍乂
曙	日四耂
稽	禾尤匕日
簪	竹旡旡日
偎	亻田衤
潁	匕水頁
恙	羊心
敞	小冂口攵
徙	行止止
嬴	亡口月女凡
瘺	疒尸雨
祚	示𠂉匕
巽	巳巳艹廾
拇	扌母
兢	十口儿十口儿
踮	足广卜口
觴	𠂊用𠂉日一勿
汕	氵山
纓	糸貝貝女
綻	糸宀一止
亓	一廾
磺	石廿由八
囂	口口頁口口
啜	口又又又又
氰	气丰月
羥	羊一巛工
螢	火火冖虫
闞	門丁耳攵
闞	門㇕耳攵
璉	王之車
壑	卜冖一八人口又土
嗪	口丰禾
呤	口亼卩
呤	口亼龴
峨	山手戈
濂	氵广禾禾彐
閨	門土土
姊	女丿乚亻
驪	馬一冂丶一冂丶鹿
敕	木口攵
嘖	口丰貝
瞼	目亼口口人人
謁	言日勹亡
讒	言召匕匕召儿丶
愉	心亼月刂
愉	心亼月巛
溥	氵甫寸
緇	糸巛田
鄢	一止一乚火阝
捨	扌亼十口
罔	冂䒑亡
衙	行二乂口
衙	行工㇕口
懇	豸艮心
厝	厂廿日
鄙	口十圍口阝
勛	口貝力
餃	食亠八乂
錕	金日匕匕
桀	夕㐄木
痠	疒厶八夂
澎	氵士口䒑彡
宥	宀𠂇月
聿	彐キ
頡	士口頁
骸	骨亠凵人
彿	行弓刂
煽	火户习习
澱	氵尸艹廾殳
驍	馬土土土兀
驊	馬華
檻	木臣𠂉丶皿
檻	木臣𠂉一皿
隕	阝口貝
饋	食中一貝
餉	食宀口
鈥	金火
狙	犭且
惶	心白王
酣	酉甘
輒	車耳乚
杳	木日
顰	止癶頁鬼十
煦	日勹口火
鍔	金口口一丂
鍔	金口口丂一
庇	广匕匕
芥	艹亻八
苡	艹厶人
戍	戈人
蝗	虫白王
暄	日宀二日
鱷	魚王口口口口
床	广木
楽	白⺍木
泯	氵巳七
衹	衤氏
陋	阝一冂人乚
戮	习习人彡戈
壤	土衣口口甘
墉	土广尹用
揖	扌口耳
攙	扌召匕匕召儿丶
菡	艹丂⺍凵
菡	艹了⺍凵
伎	亻十又
脛	月一巛工
愕	心口口一丂
愕	心口口丂一
紳	糸申
呷	口甲
唧	口艮卩
朧	月龍
詣	言匕日
烽	火夂丰
慨	心艮旡
菂	艹白勹丶
嘸	口𠂉廿廿火
乒	丘丿
朦	月艹冖一豕
諡	言八丂皿
粱	氵刀八米
宓	宀弋八
囗	圍
峙	山土寸
侗	亻冂一口
征	行一止
鋯	金牛口
詰	言士口
淒	氵一尹女
畦	田土土
骶	骨氏一
骶	骨氏丶
膘	月西示
庾	广臼人
淬	氵亠人人十
掖	扌亠亻夂丶
柬	木四
犢	牛士四貝
逵	之土儿土
逵	之土八土
悳	十目心
秩	禾手丶
颯	立風
湜	氵日一止
蕃	艹釆田
朽	木丂
塹	車斤土
杞	木巳
蛛	虫𠂉木
啡	口非
晦	日𠂉母
傈	亻西木
佷	亻艮
餿	食臼丨又
昶	丶水日
痂	疒力口
扉	户非
嫉	女疒矢
酈	一冂丶一冂丶鹿阝
蓆	艹广廿巾
蕁	艹彐工口寸
鍼	金戊一口
謨	言艹日大
广	广
垠	土艮
萘	艹大示
蜷	虫半卩
嗤	口屮一虫
幌	巾日小兀
篆	竹彑豕
臼	臼
傭	亻广尹用
鍺	金耂
諷	言風
諳	言立日
慚	心車斤
怖	心𠂇巾
灶	火土
宁	宀丁
裱	衤丰衤
扈	户口巴
嫡	女亠八冂十口
磬	士尸殳石
嗖	口臼丨又
鍥	金丰刀大
哺	口甫
踝	足田木
叱	口匕
婢	女鬼十
婿	女足月
擀	扌十日十人干
挽	扌召儿
氾	氵卩
歹	一夕
矗	十目十目十目
叨	口刀
喙	口彑豕
晰	日木斤
晁	日儿⺍
箐	竹丰月
鼬	臼釆由
閏	門王
辷	之一
揩	扌匕匕白
砣	石宀匕
罈	午凵西日十
氬	气亞
偃	亻匚日女
濛	氵艹冖一豕
蝸	虫咼
銻	金弋弓
氐	氏一
氐	氏丶
迸	之䒑廾
酪	酉夂口
嘜	口木人人夂
咿	口亻尹
幔	巾日四又
幔	巾冖二四又
戇	立日十夂工貝心
淖	氵卜日十
渥	氵尸至
瑰	王鬼
蔗	艹广廿火
嗓	口又又又木
郜	牛口阝
籮	竹四糸隹
鉚	金卯
膛	月小冖口土
孢	子勹巳
黒	田土火
幟	巾立日戈
涔	氵山亼㇕
嬡	女爪冖心夂
饗	乚凵丶艮阝食
饗	乚凵艮阝食
瓚	王牛儿牛儿貝
蛻	虫八口儿
浠	氵乂𠂇巾
汛	氵乙十
剿	巛田木刂
菿	艹至刂
噌	口八四日
噌	口八田日
円	冂丨一
掣	牛巾刂手
娑	氵小丿女
蔬	艹足亠厶川
枷	木力口
啉	口木木
俑	亻龴用
腋	月亠亻夂丶
癒	疒亼月刂心
癒	疒亼月巛心
憫	心門文
灞	氵雨革月
吆	口幺
憊	亻廿丿用心
舫	舟方
瀏	氵卯金刂
羿	习习廾
為	爲
璜	王廿由八
拄	扌丶王
郴	木木阝
蟾	虫𠂊厂八言
腚	月宀一止
誡	言戈廾
吝	文口
沏	氵七刀
渙	氵𠂊冂八大
穹	穴弓
媞	女日一止
嘌	口西示
岫	山由
筵	竹廴丿止
裊	鳥衣
矜	予丿亼㇕
掬	扌勹米
皿	皿
纂	竹目大糸
徊	行圍口
鰓	魚田心
誨	言𠂉母
焗	火尸㇕口
鬍	長彡十口月
撂	扌田夂口
覷	虎业見
覷	虎丘見
嗽	口木口欠
曇	日雨二厶
悖	心十冖子
耘	耒二厶
蜃	辰虫
郢	口王阝
郢	口亻土阝
罘	四不
鍘	金貝刂
銓	金人王
鏽	金尹爿一爿
雒	夂口隹
勐	子皿力
鑾	言糸糸金
蔻	艹宀一兀卜又
榴	木卯田
蹺	足土土土兀
伺	亻㇕一口
尒	人小
饑	食幺幺戈人
諞	言户冊
瀦	氵豕耂
胜	月生
芣	艹不
榛	木丰禾
弌	弋一
簍	竹婁
筏	竹亻戈
銬	金耂丂
奐	𠂊冂八大
癩	疒木口𠂊貝
癩	疒木口刀貝
淅	氵木斤
澹	氵𠂊厂八言
禱	示士㇕工一口寸
辟	尸口辛
姥	女耂匕
欖	木臣𠂉丶四見
欖	木臣𠂉一四見
嗝	口一口冂八丁
譏	言幺幺戈人
粕	米白
燊	火火火木
甾	巛田
坷	土丁口
莢	艹大人人
靄	雨言日勹亡
顎	口口一丂頁
顎	口口丂一頁
嶄	山車斤
髖	骨宀艹見丶
仆	亻卜
佚	亻手丶
脯	月甫
痢	疒禾刂
煸	火户冊
灃	氵丰丰山一口䒑
汰	氵大丶
濯	氵习习隹
萼	艹口口一丂
萼	艹口口丂一
楔	木丰刀大
軻	車丁口
輻	車一口田
呲	口止匕
唰	口尸巾刂
疃	田立田土
煊	火宀二日
淶	氵木人人
亍	一丁
圳	土川
煉	火木四
煉	火木日
洵	氵勹日
犟	弓口虫牛
犟	弓厶虫牛
顳	耳耳耳頁
槎	木羊工
甌	匚口口口瓦
峭	山小月
気	气乂
猥	犭田衤
惺	心日生
締	糸亠八冖巾
楣	木尸目
嘩	口華
僚	亻一火日小
忿	八刀心
孵	卯丶丶爪子
紊	文糸
罄	士尸殳午凵
髯	長彡冂土
贅	士方攵貝
贅	土方攵貝
贅	丰力攵貝
捺	扌大示
懋	木予丿木心
魘	厂日月犬鬼
齲	齒丿口冂厶
帷	巾隹
嶸	山火火冖木
雉	矢隹
舸	舟丁口
膈	月一口冂八丁
洩	氵申丿
寞	宀艹日大
蹇	宀甘八足
櫓	木魚日
蚜	虫牙
畸	田大丁口
箕	竹甘廾
匆	勿丶
壕	土亠口冖豕
撣	扌口口甲一
堇	艹口丰
堇	廿口丰
蕞	艹日耳又
蕞	艹冖二耳又
涎	氵廴丿止
渲	氵宀二日
寳	宀王𠂉小貝
寳	宀王𠂊小貝
寳	宀王竹八貝
闋	門癶一大
耽	耳冖儿
菅	艹宀㠯
仝	人工
猩	犭日生
詮	言人王
疵	疒止匕
瀧	氵龍
遐	之尸二コ又
袂	衤㇕大
霾	雨豸田土
虔	虎文
蹴	足亠口小尤
鉸	金亠八乂
舶	舟白
斕	文門木四
謐	言弋八皿
燎	火一火日小
熠	火习习白
闔	門土厶皿
殃	一夕冂大
軫	車人彡
噼	口尸口辛
遏	之日勹亡
銼	金人人土
舛	夕㐄
匕	匕
謔	言虎匚一
隘	阝䒑八皿
殑	一夕十口儿
騾	馬田糸
檜	木亼四日
囝	圍子
喈	口匕匕白
稈	禾日干
澍	氵士口䒑寸
珩	王行
欏	木四糸隹
畈	田厂又
畈	田𠂆又
鵠	牛口鳥
衢	行目目隹
譴	言之中一㠯
泌	氵弋八
宕	宀石
邈	之豸白儿
苄	艹亠卜
菀	艹宀夕卩
礬	乂乂木木大石
岷	山巳七
贍	貝𠂊厂八言
俘	亻爪子
衾	亼㇕衣
衕	行冂一口
鈀	金巴
狩	犭宀寸
襬	衤四厶月匕匕
蠡	彑豕虫虫
邰	厶口阝
殆	一夕厶口
鬃	長彡宀示
啶	口宀一止
晌	日宀口
睫	目一彐止
飭	食𠂉力
鈿	金田
獾	犭艹口口隹
鯤	魚日匕匕
琍	王禾刂
捍	扌日干
芾	艹一巾
彧	弋口一彡
蝠	虫一口田
嘣	口山月月
岢	山丁口
鑣	金鹿火
鷲	亠口小尤鳥
訛	言亻匕
詡	言习习
潯	氵彐工口寸
靛	丰月宀一止
莆	艹甫
礪	石厂艹日冂厶
氦	气亠凵人
佯	亻羊
膀	月亠八冖方
瀆	氵士四貝
緗	糸木目
姻	女圍大
繽	糸宀一癶貝
葭	艹尸二コ又
鑒	臣𠂉丶四金
鑒	臣𠂉一四金
贓	貝戈爿臣
徳	行十四心
関	門䒑大
耆	耂匕日
捫	扌門
拚	扌厶廾
籤	竹人人戈非一
夙	几一夕
腑	月广亻寸
謾	言日四又
謾	言冖二四又
蟄	土半丸虫
樾	木走戈乚
咣	口小兀
噙	口人亠乂凵冂厶
猝	犭亠人人十
訖	言𠂉乙
熒	火火冖火
潼	氵立田土
窒	穴至
翌	习习立
奼	女丿七
夔	八頁止巳夂
髂	骨宀夂口
熏	千四二火
刈	乂刂
鉭	金日一
鍬	金禾火
舷	舟亠幺
肟	月一丂
肟	月丂一
鱔	魚羊䒑口
誑	言犭王
氓	亡巳七
豢	半豕
忱	心冖儿
洧	氵𠂇月
雇	户隹
閭	門口口
閭	門口丿口
媳	女自心
蠹	一中冖石虫虫
荐	艹一亻子
蟮	虫羊䒑口
踰	足亼月刂
踰	足亼月巛
彡	彡
鍶	金田心
対	文寸
庖	广勹巳
鶩	予丿攵鳥
埂	土一日乂
琥	王虎
賁	十艹貝
哏	口艮
俟	亻厶矢
懾	心耳耳耳
汙	氵丁一
紺	糸甘
抻	扌申
缶	午凵
絛	亻丨夂糸
絛	亻丨攵糸
鏤	金婁
汴	氵亠卜
忝	一大心
璨	王卜夕又米
虯	虫凵
躡	足耳耳耳
喱	口厂田土
嵇	禾尤山
鉞	金戈乚
鈊	金心
鴛	夕卩鳥
誣	言工人人
諍	言爪尹
諍	言𠂊尹
怵	心木丶
怵	心十儿丶
湍	氵山而
葳	艹戊一女
藜	艹禾丿刀人水
輟	車又又又又
僻	亻尸口辛
鏃	金方𠂉矢
瓤	衣口口甘瓜
鶉	亠口子鳥
翦	䒑月刂习习
羯	羊日勹亡
熳	火日四又
熳	火冖二四又
澶	氵亠圍口日一
滸	氵言午
廴	廴
燾	士㇕工一口寸火
撾	扌之咼
拯	扌㇕水一
芡	艹欠
枰	木干八
俸	亻丰キ
翱	白大十习习
奠	八酉大
銥	金衣
肱	月𠂇厶
瘧	疒虎匚一
屙	尸阝丁口
邕	巛口巴
埒	土爪寸
茱	艹𠂉木
槿	木艹口丰
槿	木廿口丰
梔	木𠂆一巴
楹	木㇕丿又皿
僥	亻土土土兀
倖	亻土半
慍	心圍人皿
玟	王文
礎	石木木足
矽	石夕
蛭	虫至
哽	口一日乂
髁	骨田木
骰	骨殳
氡	气夂冫
鏜	金小冖口土
飧	夕食
訕	言山
漚	氵匚口口口
翩	户冊习习
祟	屮凵示
殉	一夕勹日
塬	土厂白小
琬	王宀夕卩
剋	十口儿刂
芩	艹亼㇕
様	木羊水
硎	石一廾刂
冂	冂
峁	山卯
淦	氵金
皰	皮勹巳
収	凵又
苒	艹冂土
箔	竹氵白
鐨	金弓刂貝
洎	氵自
輦	夫夫車
薆	艹爪冖心夂
跤	足亠八乂
嗌	口䒑八皿
顥	日亠口小頁
懟	业羊寸心
牲	牛生
氳	气圍人皿
牒	爿廿乚木
戦	⺍甲一戈
漩	氵方𠂉足
殞	一夕口貝
玳	王亻弋
芪	艹氏
皙	木斤白
礫	石白幺幺木
賄	貝𠂇月
僳	亻西米
饈	食羊彐丨
胍	月瓜
鮎	魚卜口
詒	言厶口
悵	心長
涸	氵圍十口
綬	糸爪冖又
攘	扌衣口口甘
嚄	口艹隹又
喓	口西女
歟	臼一乚丨廾欠
牋	爿戈戈
鐲	金四勹虫
変	大八夂
淥	氵彑水
宀	宀
剜	宀夕卩刂
孖	子子
卍	㇕丨一丨
綣	糸半卩
圻	土斤
苣	艹匚コ
芍	艹勹丶
菩	艹立口
蠔	虫亠口冖豕
哂	口西
佣	亻用
仞	亻刀丶
諏	言耳又
冽	冫一夕刂
廡	广𠂉廿廿火
綃	糸小月
耦	耒日冂厶
桉	木宀女
粲	卜夕又米
喳	口木日一
啐	口亠人人十
儺	亻廿口夫隹
儺	亻艹口夫隹
鏗	金臣又土
諛	言臼人
庋	广十又
粑	米巴
籹	米女
瀘	氵虎田皿
鋈	氵丿大金
滘	氵冖儿工口
滘	氵冖八工口
戾	户犬
亟	了口又一
亟	丂口又一
嬈	女土土土兀
堀	土尸屮凵
莧	艹見
蘑	艹广木木石
蘑	艹广十儿十儿石
輾	車尸廿衤
跛	足皮
崾	山西女
顓	山而頁
鉍	金弋八
鎔	金穴人口
鯽	魚艮卩
憬	心日亠口小
愀	心禾火
湮	氵西土
洇	氵圍大
祜	示十口
闡	門口口甲一
亙	二𠂊冫
囍	士口䒑口士口䒑口
撻	扌之土羊
芏	艹土
莣	艹亡心
蒞	艹氵亻立
檫	木宀䏑又示
饕	口丂虎食
盹	目丿屮
盹	目一屮
脩	亻丨夂月
脩	亻丨攵月
畲	人示田
鎵	金宀豕
謗	言亠八冖方
糰	米圍一日厶寸
灩	氵丰丰山一口䒑土厶皿
寤	宀爿二乂口
寤	宀爿工㇕口
縉	糸一业日
縉	糸二厶厶日
娉	女由丂
垟	土羊
硌	石夂口
盎	冂大皿
睢	目隹
徠	行木人人
斛	𠂊用冫十
泮	氵半
汊	氵又丶
灤	氵言糸糸木
繕	糸羊䒑口
歿	一夕勹又
碴	石木日一
逕	之一巛工
哮	口耂子
嘬	口日耳又
嘬	口冖二耳又
嶂	山立日十
乓	丘丶
逯	之彐水
閾	門戈口一
葽	艹西女
枳	木口八
杓	木勹丶
鄴	业半木阝
岬	山甲
誥	言牛口
汏	氵大
売	士冖儿
埭	土尹⺍
螯	士方攵虫
螯	土方攵虫
螯	丰力攵虫
孛	十冖子
啷	口丶艮阝
笥	竹㇕一口
鵒	八人口鳥
狡	犭亠八乂
竦	立木口
癰	疒巛口巴隹
瀹	氵亼口口口冊
潙	氵爲
硐	石冂一口
蹶	足厂䒑屮欠
蹋	足日习习
篡	竹目大厶
俚	亻田土
伈	亻心
魷	魚尤
鰻	魚日四又
鰻	魚冖二四又
讕	言門木四
讕	言門木日
恣	二欠心
恣	冫欠心
羧	羊厶八夂
紂	糸寸
緲	糸目小丿
戩	二厶厶日戈
児	丨日儿
呿	口土厶
胄	由月
禺	日冂厶
矚	目尸水四勹虫
笆	竹巴
鉈	金宀匕
竣	立厶八夂
甑	八四日瓦
甑	八田日瓦
悸	心禾子
煬	火日一勿
縐	糸勹屮勹屮
玓	王勹丶
萇	艹長
蓯	艹行人人止
韭	非一
暝	日冖日亠八
凼	水凵
睨	目臼儿
仩	亻上
倌	亻宀㠯
銦	金圍大
鍇	金匕匕白
肪	月方
馗	九八頁
孺	子雨而
緝	糸口耳
殮	一夕亼口口人人
琮	王宀示
芫	艹一兀
菈	艹扌立
檣	木土人人圍口
賚	木人人貝
掱	手手手
秸	禾士口
儼	亻口口厂丁耳攵
儼	亻口口厂㇕耳攵
皎	白亠八乂
龕	亼口龍
諼	言爪一𠂇又
瘓	疒𠂊冂八大
癆	疒火火冖力
煅	火厂三殳
慵	心广尹用
涙	氵户大
惢	心心心
耨	耒辰寸
蜇	扌斤虫
莒	艹口口
莒	艹口丿口
蘅	艹行𠂊田大
苕	艹召
橇	木毛毛毛
翳	匚矢殳习习
哐	口匚王
賑	貝辰
崛	山尸屮凵
篁	竹白王
偌	亻艹𠂇口
釧	金川
鈮	金尸匕
諺	言立丿彡
庵	广大申
炷	火丶王
濄	氵之咼
洳	氵女口
隧	阝之八豕
塒	土日土寸
茆	艹卯
橈	木土土土兀
靨	厂日月犬頁圍
蜈	虫口一大
蜈	虫口乚大
蜈	虫口乚廾
喹	口大土土
咲	口䒑大
冑	由冂二
乄	丿丶
偠	亻西女
澧	氵曲一口䒑
屜	尸行廿乚
卐	乚一丨一
纈	糸士口頁
姒	女厶人
瓔	王貝貝女
柘	木石
枋	木方
虻	虫亡
釕	金了
廕	广阝亼㇕二厶
惰	心𠂇工月
懺	心人人戈非一
洮	氵儿氵
蚤	又冫虫
蚤	又丶虫
婊	女丰衤
斡	十日十人冫十
韃	革之土羊
轅	車土口衤
栩	木习习
攴	卜又
哧	口土火
睞	目木人人
僖	亻士口䒑口
傣	亻丰水
倏	亻丨夂犬
倏	亻丨攵犬
銫	金𠂊巴
銃	金亠厶儿
諤	言口口一丂
諤	言口口丂一
苹	艹干八
蕨	艹厂䒑屮欠
茴	艹圍口
藐	艹豸白儿
芠	艹文
酵	酉耂子
蛔	虫圍口
崮	山圍十口
嶠	山丿大冂口
膦	月米夕㐄
鮭	魚土土
匈	勹乂凵
譙	言隹火
洹	氵二日
沢	氵尸丶
璁	王囟夂心
璁	王囟丿乂心
蒯	艹月月刂
醞	酉圍人皿
椋	木亠口小
叵	匚口
齦	齒艮
嗶	口甲艹二
唾	口千艹二
哖	口𠂉㐄
噔	口癶一口䒑
笫	竹丿乚亻
惚	心勿心
澮	氵亼四日
閫	門圍木
瑙	王巛囟
棹	木卜日十
蜥	虫木斤
蛀	虫丶王
螟	虫冖日亠八
唏	口乂𠂇巾
畹	田宀夕卩
黍	禾人水
鑊	金艹隹又
腓	月非
詎	言匚コ
庥	广亻木
濰	氵糸隹
緘	糸戊一口
攣	言糸糸手
轂	士冖一車殳
蓴	艹一日厶寸
蒔	艹日土寸
佇	亻宀丁
鈐	金亼㇕
貉	豸夂口
瀕	氵止癶頁
闃	門目犬
翀	习习中
妊	女工一
妊	女丿士
紓	糸予
荇	艹行
蔸	艹白卯儿
艿	艹㇕丿
櫛	木竹艮卩
斫	石斤
咻	口亻木
箴	竹戊一口
适	之舌
飴	食厶口
訝	言牙
淙	氵宀示
嫦	女小冖口巾
弁	厶廾
韉	革艹鹿一乚火
萜	艹巾卜口
薏	艹立日心
趺	足夫
賒	貝人示
郗	乂𠂇巾阝
饌	食巳巳艹廾
虢	爪寸虎
慷	心广尹⺍
濼	氵白幺幺木
実	宀丰
寥	宀习习人彡
褋	衤廿乚木
摑	扌圍戈口一
邯	甘阝
蔑	艹四戈人
楮	木耂
圧	厂土
砥	石氏一
砥	石氏丶
迄	之𠂉乙
儆	亻艹勹口攵
讎	隹言隹
銪	金𠂇月
臊	月口口口木
鴕	鳥宀匕
誆	言匚王
咫	尸丶口八
鍪	予丿攵金
婺	予丿攵女
綹	糸夂卜口
搪	扌广尹口
葑	艹土土寸
噫	口立日心
瞰	目丁耳攵
瞰	目㇕耳攵
攵	攵
僮	亻立田土
佗	亻宀匕
鐫	金隹冂凵
塾	亠口子丸土
旎	方𠂉尸匕
壅	亠乚凵隹土
懦	心雨而
発	癶二儿
繚	糸一火日小
繹	糸四土半
酆	丰丰山一口䒑阝
藹	艹言日勹亡
箬	竹艹𠂇口
爰	爪一𠂇又
鋮	金戊㇕
鏘	金爿䏑寸
魴	魚方
詼	言𠂇火
謖	言田八夂
炔	火㇕大
燼	火尹一火皿
妲	女日一
勱	艹日冂厶力
蓼	艹习习人彡
鸕	虎田皿鳥
螭	虫亠乂凵冂厶
峒	山冂一口
県	目乚小
狽	犭貝
觥	𠂊用小兀
羔	羊火
熘	火卯田
衿	衤亼㇕
騖	予丿攵馬
盂	丁一皿
髦	長彡毛
萸	艹臼人
磧	石丰貝
蜆	虫見
踞	足尸十口
昴	日卯
僾	亻爪冖心夂
卮	𠂆一卩
氷	水丶
詬	言𠂆一口
癥	疒行山一王攵
湫	氵禾火
綵	糸爪木
娓	女尸毛
恚	土土心
莜	艹亻丨夂
莜	艹亻丨攵
蘚	艹魚羊
尢	尤
匭	匚車九
籟	竹木口𠂊貝
籟	竹木口刀貝
魑	鬼亠乂凵冂厶
頦	亠凵人頁
汜	氵巳
縝	糸十目廾
縝	糸匕目廾
芰	艹十又
椏	木亞
榫	木隹十
椽	木彑豕
蟠	虫釆田
啫	口耂
蹊	足爪幺大
晞	日乂𠂇巾
詈	四言
肴	乂𠂇月
銠	金耂匕
鈑	金厂又
鈑	金𠂆又
獠	犭一火日小
誚	言小月
諂	言𠂊臼
痿	疒禾女
焓	火亼㇕口
湃	氵手一丰
湟	氵白王
祉	示止
縵	糸日四又
縵	糸冖二四又
妗	女亼㇕
擻	扌婁攵
菘	艹木八厶
菏	艹氵丁口
葯	艹糸勹丶
砦	止匕石
鶚	口口一丂鳥
睪	四土半
釁	臼冂一口冖酉八刀
鏞	金广尹用
啻	亠八冖巾口
旖	方𠂉大丁口
饔	亠乚凵隹食
劭	召力
姘	女䒑廾
畿	幺幺戈田
坭	土尸匕
霈	雨氵一巾
呔	口大丶
崧	山木八厶
箸	竹耂
稔	禾亼㇕心
籩	竹之自穴方
乂	乂
鏵	金華
塍	月半土
詫	言宀丿七
庹	广廿尸丶
疚	疒𠂊丶
怛	心日一
瀋	氵宀釆田
黽	黽
窿	穴阝夂一生
芐	艹下
霰	雨廿月攵
歩	止小丿
噘	口厂䒑屮欠
啾	口禾火
崙	山亼冊
俅	亻十⺍丶
鎰	金䒑八皿
腱	月廴彐キ
鱸	魚虎田皿
処	夂几
瘁	疒亠人人十
浹	氵大人人
漓	氵亠乂凵冂厶
寔	宀日一止
禕	示㐄口㐄
闆	門口口口
迂	之丁一
菰	艹子瓜
碇	石宀一止
嗬	口艹亻丁口
笄	竹一廾
筧	竹見
鐮	金广禾禾彐
凇	冫木八厶
洌	氵一夕刂
袒	衤日一
鄄	西土阝
櫚	木門口口
櫚	木門口丿口
呋	口夫
囁	口耳耳耳
唳	口户犬
唳	口户大
篙	竹亠口冂口
氛	气八刀
鋌	金廴工一
鋌	金廴丿士
鋌	金廴亻土
詘	言屮凵
賡	广彐人貝
禛	示十目廾
禛	示匕目廾
闥	門之土羊
嬤	女广木木幺
嬤	女广十儿十儿幺
垚	土土土
垃	土立
蕎	艹丿大口冂口
蚴	虫幺力
跖	足石
鄖	口貝阝
踉	足丶艮
牘	爿士四貝
佃	亻田
腈	月丰月
腊	月廿日
膺	广亻隹月
焐	火二乂口
焐	火工㇕口
洱	氵耳
衲	衤冂人
邏	之四糸隹
蛩	工凡虫
琶	王王巴
菟	艹召儿丶
薌	艹乚凵丶艮阝
薌	艹乚凵艮阝
稷	禾田八夂
簣	竹中一貝
笈	竹𠂊又
鱟	臼乂乂冖魚
鄣	立日十阝
痙	疒一巛工
惲	心冖車
冨	冖一口田
韞	㐄口㐄日皿
蘼	艹广木木非
蘼	艹广十儿十儿非
螅	虫自心
嚯	口雨隹
篪	竹𠂆虎
夊	夂
誹	言非
讖	言人人戈非一
燻	火千四二火
沮	氵且
轡	車糸糸口
挹	扌口巴
逑	之十⺍丶
鞅	革冂大
桜	木⺍女
蚧	虫亻八
骯	骨亠几
笏	竹勿
鎦	金卯田
酋	八酉
鎏	氵亠厶川金
滁	氵阝亼木
媸	女屮一虫
媧	女咼
并	䒑廾
苫	艹卜口
楸	木禾火
檳	木宀一癶貝
賾	臣丰貝
迓	之牙
匱	匚中一貝
蛘	虫羊
踵	足千日土
炅	日火
罹	四心隹
笱	竹勹口
鈹	金皮
肼	月二刂
臏	月宀一癶貝
鮃	魚干八
旃	方𠂉冊丶
懊	心宀米大
涫	氵宀㠯
瀰	氵弓一八巾乂乂乂乂
遽	之虎豕
陛	阝匕匕土
紸	糸丶王
觳	士冖一𠂊用殳
鬩	鬥臼儿
摶	扌一日厶寸
揸	扌木日一
苊	艹厂卩
萄	艹勹午凵
薜	艹尸口辛
囈	口艹土儿土丸二厶
囈	口艹土八土丸二厶
嚦	口厂禾禾止
崆	山穴工
佽	亻二欠
佽	亻冫欠
銖	金𠂉木
獺	犭木口𠂊貝
獺	犭木口刀貝
脘	月宀一兀
芻	勹屮勹屮
贇	文戈止貝
惻	心貝刂
闈	門㐄口㐄
嫵	女𠂉廿廿火
舂	丰臼
璦	王爪冖心夂
蔦	艹鳥
橢	木阝𠂇工月
达	之大
唇	辰口
豕	豕
呎	口尸丶
嵊	山禾北
睋	目手戈
幃	巾㐄口㐄
况	冫口儿
褰	宀甘八衣
冗	冖几
恵	一由心
薨	艹四冖一夕匕
蓀	艹子丿糸
葒	艹糸工
鏨	車斤金
椴	木厂三殳
齶	齒口口一丂
齶	齒口口丂一
噲	口亼四日
雎	且隹
鏂	金匚口口口
腩	月十冂半
鮫	魚亠八乂
謫	言亠八冂十口
瘴	疒立日十
憚	心口口甲一
満	氵廿冂山
浼	氵召儿
閬	門丶艮
媼	女圍人皿
絀	糸屮凵
芎	艹弓
酊	酉丁
笞	竹厶口
侮	亻𠂉母
胱	月小兀
肓	亡月
痧	疒氵小丿
袢	衤半
黿	一兀黽
髡	長彡兀
擢	扌习习隹
麴	木人人夂勹米
厴	厂日月犬甲
嘁	口戊上小
罅	午凵虎爪丁
佼	亻亠八乂
侷	亻尸㇕口
釔	金乙
鑠	金白幺幺木
亳	亠口冖丿七
悴	心亠人人十
閌	門亠几
壎	土千四二火
菓	艹田木
梆	木丰阝
乩	卜口乚
呶	口女又
賂	貝夂口
誄	言耒
疽	疒且
淄	氵巛田
逅	之𠂆一口
逄	之夂㐄
亜	亞
堺	土田亻八
擷	扌士口頁
菽	艹上小又
蓖	艹囟匕匕
菔	艹月卩又
苧	艹宀丁
蟆	虫艹日大
齪	齒足
嘭	口士口䒑彡
尜	小大小
嵋	山尸目
佤	亻瓦
鼾	自田廾干
鎩	金乂木殳
凊	冫丰月
猷	八酉犬
閎	門𠂇厶
閿	門爪冖又
卩	卩
縭	糸亠乂凵冂厶
螚	厶月匕匕虫
萁	艹甘廾
葩	艹白巴
蛐	虫曲
勖	日目力
勖	冖二目力
岜	山巴
笪	竹日一
舐	舌氏
佶	亻士口
倨	亻尸十口
餒	食爪女
鳧	鳥几
詿	言土土
溉	氵艮旡
赭	土火耂
檠	艹勹口攵木
桅	木𠂊厂卩
眥	止匕目
訾	止匕言
嘹	口一火日小
嚀	口宀心皿丁
犇	牛牛牛
伝	亻二厶
鱘	魚彐工口寸
諟	言日一止
庠	广羊
慳	心臣又土
慟	心千日土力
葙	艹木目
杈	木又丶
砧	石卜口
蛉	虫亼卩
蛉	虫亼龴
蟀	虫亠幺⺍十
咭	口士口
嚙	口齒
飫	食丿大
鈰	金亠巾
惕	心日勿
惘	心冂䒑亡
惦	心广卜口
潦	氵一火日小
窠	穴田木
裨	衤鬼十
迨	之厶口
矸	石干
贗	厂亻鳥貝
蜓	虫廴工一
蜓	虫廴丿士
蜓	虫廴亻土
嘵	口土土土兀
唚	口彐冖又
餼	食气米
褻	衣土儿土丸
褻	衣土八土丸
袞	衣八口
懍	心亠圍口禾
褔	衤一口田
蚩	屮一虫
櫱	屮丿㠯辛木
殯	一夕宀一癶貝
耒	耒
芄	艹丸
榷	木冖隹
奄	大申
碚	石立口
喑	口立日
鋨	金手戈
繇	爪午凵丿糸
繇	䏑午凵丿糸
裾	衤尸十口
窈	穴幺力
豉	一口䒑十又
箌	竹至刂
讜	言小冖口四土火
讜	言小冖口田土火
劾	亠凵人力
憧	心立田土
裑	衤身
裼	衤日勿
孿	言糸糸子
嫠	二木攵厂女
琇	王禾㇕丿
荏	艹亻工一
荏	艹亻丿士
蘢	艹龍
杪	木小丿
榔	木丶艮阝
隹	隹
餳	食日一勿
鉺	金耳
鎌	金禾禾彐
旆	方𠂉一巾
癇	疒門月
燧	火之八豕
遑	之白王
橐	一中冖石木
圪	土𠂉乙
嗇	土人人圍口
駢	馬䒑廾
藪	艹婁攵
芃	艹凡
槭	木戊上小
棰	木千艹二
噥	口曲辰
嗥	口白大十
峴	山見
岣	山勹口
佉	亻土厶
魈	鬼小月
頎	斤頁
鏌	金艹日大
颼	風臼丨又
詵	言牛儿
諢	言冖車
覚	⺍冖見
瀬	氵木口頁
珥	王耳
駟	馬四
茤	艹夕夕
砭	石丿之
碓	石隹
蟑	虫立日十
蚓	虫弓丨
嗵	口之龴用
嵴	山⺍人月
憩	舌自心
俁	亻口乚大
臚	月虎田皿
昝	夂卜日
隗	阝鬼
繾	糸之中一㠯
紉	糸刀丶
壊	土十四衣
琚	王尸十口
葫	艹十口月
鞣	革予丿木
顴	艹口口隹頁
蕕	艹犭八酉
醴	酉曲一口䒑
饜	厂日月犬食
齠	齒召
顒	日冂厶頁
嘗	小冖口匕日
嵛	山亼月刂
嵛	山亼月巛
牯	牛十口
簟	竹西日十
笮	竹𠂉匕
囪	囟丿乂
儈	亻亼四日
鷂	爪午凵鳥
鷂	䏑午凵鳥
譲	言衣八甘
麝	鹿身寸
沌	氵丿屮
沌	氵一屮
勰	力力力田心
婀	女阝丁口
縞	糸亠口冂口
瑁	王日目
瑁	王冖二目
綦	甘廾糸
齷	齒尸至
喋	口廿乚木
躋	足齊
瓴	亼卩瓦
瓴	亼龴瓦
毖	匕匕弋八
悽	心一尹女
愫	心丰糸
悚	心木口
搴	宀甘八手
朶	㇕丿木
増	土八田日
菋	艹口二木
驀	艹日大馬
醪	酉习习人彡
囀	口車一日厶寸
趿	足𠂊又
蹌	足人户口
嗍	口䒑屮月
杲	日木
暘	日日一勿
骷	骨十口
爨	臼冂一口冖木木大火
羸	亡口月羊凡
誶	言亠人人十
廄	广艮殳
瀲	氵亼口口人人攵
攫	扌目目隹又
茼	艹冂一口
齜	齒止匕
圜	圍四一口衤
秣	禾一木
僭	亻旡旡日
囟	囟
鑭	金門木四
鑭	金門木日
鰳	魚革力
鰨	魚日习习
慊	心禾禾彐
媯	女爲
鞀	革召
樅	木行人人止
団	圍寸
罌	貝貝午凵
儔	亻士㇕工一口寸
羶	羊亠圍口日一
汨	氵日
閼	門方人冫
閽	門氏日
閡	門亠凵人
譬	尸口辛言
縹	糸西示
摒	扌尸䒑廾
齬	齒二乂口
齬	齒工㇕口
嘧	口宀弋八山
嵬	山鬼
瞑	目冖日亠八
穡	禾土人人圍口
氪	气十口儿
笳	竹力口
魃	鬼犬丿
魃	鬼犬㇕
佸	亻舌
艉	舟尸毛
穌	魚禾
浯	氵二乂口
浯	氵工㇕口
溱	氵丰禾
阡	阝千
璩	王虎豕
醮	酉隹火
硤	石大人人
蠊	虫广禾禾彐
圉	圍土半
嚓	口宀䏑又示
纍	田田田糸
賙	貝用口
豺	豸十丿
獐	犭立日十
旄	方𠂉毛
広	广厶
糝	米厶厶厶人彡
泖	氵卯
溏	氵广尹口
裉	衤艮
戸	户
琺	王氵土厶
芟	艹殳
棖	木長
柜	木匚コ
蚨	虫夫
蟶	虫耳口王
蟶	虫耳口亻土
俎	人人且
肫	月丿屮
肫	月一屮
糍	米䒑幺幺
槊	䒑屮月木
涑	氵木口
涪	氵立口
漉	氵鹿
緄	糸日匕匕
彗	丰丰彐
鞦	革禾火
莔	艹圍八冂
躉	艹日冂厶足
櫪	木厂禾禾止
齔	齒匕
屾	山山
鶻	骨鳥
泱	氵冂大
泫	氵亠幺
鴆	冖儿鳥
帚	彐冖巾
埕	土口王
埕	土口亻土
珪	王土土
瑗	王爪一𠂇又
茁	艹屮凵
檄	木白方攵
竽	竹丁一
稗	禾鬼十
佺	亻人王
鍆	金門
鯢	魚臼儿
戠	立日戈
咨	二欠口
咨	冫欠口
淀	氵宀一止
謇	宀甘八言
逖	之犭火
羋	丨卜卜キ
靼	革日一
莋	艹亻𠂉匕
唵	口大申
吩	口八刀
哞	口厶牛
羆	四厶月匕匕火
嶧	山四土半
迤	之𠂉也
秈	禾山
簞	竹口口甲一
佞	亻二女
鉿	金亼口
艫	舟虎田皿
諉	言禾女
瘍	疒日一勿
憒	心中一貝
郯	火火阝
邋	之巛圍乂巛
闐	門十目廾
闐	門匕目廾
孃	女衣口口甘
縊	糸䒑八皿
垌	土冂一口
璀	王山隹
芘	艹匕匕
蹩	巾⺍攵足
昉	日方
鱈	魚雨彐
鮒	魚亻寸
涿	氵豕
鼐	㇕丿目爿爿
戛	頁戈
髪	長彡𠂇又
瑀	王丿口冂厶
驄	馬囟夂心
驄	馬囟丿乂心
璣	王幺幺戈人
芨	艹𠂊又
蠓	虫艹冖一豕
蚪	虫冫十
吒	口丿七
瞋	目十目廾
瞋	目匕目廾
毎	𠂉母十
倥	亻穴工
猓	犭田木
頫	儿⺍頁
褥	衤辰寸
嬖	尸口辛女
孀	女雨木目
縋	糸之丿㠯
珣	王勹日
璘	王米夕㐄
菠	艹氵皮
卣	卜圍コ
嚶	口貝貝女
跚	足冊
嶷	山匕矢龴足
牖	爿户甫
徨	行白王
鉄	金手丶
豸	豸
溧	氵西木
寀	宀爪木
阱	阝二刂
愍	巳七攵心
皴	厶八夂皮
撳	扌金欠
蘺	艹亠乂凵冂厶隹
櫸	木臼一乚丨廾キ
磣	石厶厶厶人彡
蠐	虫齊
咑	口扌丁
踔	足卜日十
黜	四土火屮凵
黜	田土火屮凵
崍	山木人人
魎	鬼一巾人人
偸	亻亼月巛
兗	亠八口儿
淝	氵月巴
鷸	予丿冂儿口鳥
鷸	予丿冂八口鳥
続	糸士冖儿
梘	木見
虺	兀虫
磋	石羊工
蠛	虫艹四戈人
蠖	虫艹隹又
哃	口冂一口
吽	口牛
徘	行非
粼	米夕㐄巛
烊	火羊
紆	糸丁一
紈	糸丸
埗	土止癶
鄹	耳又亻阝
瓁	王艹隹又
鸛	艹口口隹鳥
蓑	艹衣口一
酢	酉𠂉匕
醌	酉日匕匕
樘	木小冖口土
楦	木宀二日
蜒	虫廴丿止
唲	口臼儿
咜	口宀匕
彫	用口彡
偲	亻田心
鐿	金立日心
胂	月申
忤	心午
潶	氵四土火
潶	氵田土火
紜	糸二厶
艽	艹九
醭	酉业半大
蜡	虫廿日
蚝	虫毛
嚨	口龍
毬	毛十⺍丶
鍖	金甘匚儿
鍖	金甘匚八
鏍	金田糸
癜	疒尸艹廾殳
沭	氵木丶
沭	氵十儿丶
滓	氵宀辛
娌	女田土
繒	糸八四日
繒	糸八田日
跫	工凡足
鏊	士方攵金
鏊	土方攵金
鏊	丰力攵金
葶	艹亠口冖丁
酞	酉大丶
榱	木衣口一
槨	木亠口子阝
郟	大人人阝
踴	足龴用力
兎	召儿丶
倳	亻一中彐
煳	火十口月
嬛	女四一口衤
嫚	女日四又
嫚	女冖二四又
驃	馬西示
柰	木示
桁	木行
蜱	虫鬼十
餚	食乂𠂇月
鯀	魚丿糸
郞	丶艮阝
恫	心冂一口
憔	心隹火
剡	火火刂
姫	女臣
彀	士冖一弓殳
珅	王申
萿	艹氵舌
雹	雨勹巳
橄	木丁耳攵
橄	木㇕耳攵
匚	匚
蟛	虫士口䒑彡
咴	口𠂇火
噈	口亠口小尤
冏	冂儿口
冏	冂八口
髕	骨宀一癶貝
値	亻十目
俶	亻上小又
皚	白山一口䒑
錈	金半卩
遒	之八酉
畑	火田
衩	衤又丶
嬙	女土人人圍口
媄	女羊大
圮	土巳
耔	耒子
揆	扌癶一大
苤	艹不一
苴	艹且
苻	艹亻寸
婪	木木女
櫫	豕耂木
碉	石用口
咼	咼
倬	亻卜日十
饉	食艹口丰
饉	食廿口丰
彳	行
譎	言予丿冂儿口
譎	言予丿冂八口
奘	爿士大
痱	疒非
疙	疒𠂉乙
浞	氵足
湔	氵䒑月刂
潺	氵尸子子子
袷	衤亼口
爿	爿
鸝	一冂丶一冂丶鹿鳥
驤	馬衣口口甘
覲	艹口丰見
覲	廿口丰見
鄞	艹口丰阝
鄞	廿口丰阝
蕗	艹足夂口
梶	木尸毛
邨	丿屮阝
邨	一屮阝
鹺	卜圍乂羊工
鼉	口口田一黽
鴰	舌鳥
伲	亻尸匕
劬	勹口力
炤	火召
単	⺍甲一
閶	門日日
恿	龴用心
坍	土冊丶
垸	土宀一兀
鬟	長彡四一口衤
耪	耒亠八冖方
芑	艹巳
逋	之甫
蚶	虫甘
曷	日勹亡
侈	亻夕夕
刖	月刂
獯	犭千四二火
觶	𠂊用口口甲一
鰍	魚禾火
旒	方𠂉亠厶川
忖	心寸
惆	心用口
閂	門一
邐	之一冂丶一冂丶鹿
鬮	鬥龜
驁	士方攵馬
驁	土方攵馬
驁	丰力攵馬
掇	扌又又又又
鶘	十口月鳥
鞫	革勹言
槲	木𠂊用冫十
齟	齒且
噺	口立木斤
韙	日一止㐄口㐄
冄	冂二
鸚	貝貝女鳥
鉦	金一止
鋟	金彐冖又
錙	金巛田
猗	犭大丁口
堃	方方土
沔	氵丁乚㇕
灕	氵亠乂凵冂厶隹
窨	穴立日
厾	乙土厶
緦	糸田心
耄	耂匕毛
杴	木欠
蚵	虫丁口
蛄	虫十口
蠣	虫厂艹日冂厶
篦	竹囟匕匕
俳	亻非
錸	金木人人
鐐	金一火日小
獬	犭𠂊用刀牛
胝	月氏一
胝	月氏丶
礱	龍石
濉	氵目隹
洺	氵夕口
邃	之穴八豕
屐	尸行十又
経	糸又土
殄	一夕人彡
瞽	士口䒑十又目
鷙	土半丸鳥
験	馬亼口人
蠆	艹日冂厶虫
芴	艹勿
楝	木木四
鶇	木日鳥
耷	大耳
曛	日千四二火
稹	禾十目廾
稹	禾匕目廾
氤	气圍大
込	之人
臆	月立日心
髙	亠卜丨冂口
埸	土日勿
拊	扌亻寸
荑	艹大弓
芤	艹子乚
榧	木匚非
砑	石牙
垡	亻戈土
倮	亻田木
徇	行勹日
鑷	金耳耳耳
鑌	金宀一癶貝
腆	月冊廾
胗	月人彡
瘢	疒舟殳
遨	之士方攵
遨	之土方攵
遨	之丰力攵
弢	弓屮又
緙	糸革
駑	女又馬
擤	扌自田廾
匏	大一丂勹巳
匏	大丂一勹巳
尷	尤臣𠂉丶皿
尷	尤臣𠂉一皿
蝴	虫十口月
虼	虫𠂉乙
曈	日立田土
澩	臼乂乂冖水
餱	食亻コ矢
粿	米田木
渀	氵大十艹
宄	宀九
隳	阝𠂇工月人心
堋	土月月
菹	艹氵且
酐	酉干
櫳	木龍
哚	口几木
眭	目土土
鴦	冂大鳥
峰	山夂丰
侞	亻女口
飩	食丿屮
飩	食一屮
餾	食卯田
銣	金女口
胛	月甲
腴	月臼人
獰	犭宀心皿丁
詁	言十口
諑	言豕
訃	言卜
疳	疒甘
癤	疒竹艮卩
惴	心山而
怺	心丶水
窕	穴儿⺍
陟	阝止癶
悪	亞心
鼙	士口䒑十又鬼十
聵	耳中一貝
鴣	十口鳥
蕈	艹西日十
蘄	艹口口甲一斤
薺	艹齊
釅	酉口口厂丁耳攵
釅	酉口口厂㇕耳攵
楂	木木日一
楫	木口耳
碭	石日一勿
戔	戈戈
呻	口申
叺	口人
咄	口屮凵
崞	山亠口子
嶗	山火火冖力
骼	骨夂口
籙	竹金彐水
魍	鬼冂䒑亡
僉	亼口口人人
饅	食日四又
饅	食冖二四又
餛	食日匕匕
鍐	金乂凵八夂
狎	犭甲
麾	广木木毛
麾	广十儿十儿毛
羝	羊氏一
羝	羊氏丶
糲	米厂艹日冂厶
憷	心木木足
煋	火日生
燚	火火火火
窣	穴亠人人十
窸	穴釆心
褡	衤艹亼口
闍	門耂
閞	門厶廾
嬗	女亠圍口日一
絵	糸人二厶
邛	工阝
玎	王丁
瑚	王十口月
琿	王冖車
玘	王巳
茈	艹止匕
藎	艹尹一火皿
椐	木尸十口
螞	虫馬
蜘	虫矢口
嗉	口丰糸
唁	口言
躚	足之西大巳
躚	足之西大卩
筮	竹工人人
箜	竹穴工
瓮	八厶瓦
鈸	金犬丿
鈸	金犬㇕
錮	金圍十口
鍤	金千臼
鯁	魚一日乂
鰱	魚之車
粳	米一日乂
遄	之山而
裰	衤又又又又
鞴	革廿丿用
蘩	艹𠂉母攵糸
麩	木人人夂夫
碲	石亠八冖巾
觜	止匕𠂊用
跏	足力口
唎	口禾刂
崚	山土儿夂
崚	山土八夂
仵	亻午
歙	亼口习习欠
鏇	金方𠂉足
諄	言亠口子
竜	立申
蠲	䒑八皿四勹虫
粞	米西
湢	氵一口田
涳	氵穴工
蟊	予丿虫虫
媲	女囟匕匕
緱	糸亻コ矢
繅	糸巛田木
盍	土厶皿
扦	扌千
萵	艹咼
菪	艹宀石
棱	木土儿夂
棱	木土八夂
輳	車丰一大
蛞	虫舌
笤	竹召
傀	亻鬼
飪	食工一
飪	食丿士
胭	月圍大
謄	月半言
殳	殳
旮	九日
悻	心土半
巛	巛
埝	土亼㇕心
圯	土巳
栲	木耂丂
朮	十儿丶
榊	木示申
砹	石艹乂
図	圍冫乂
跣	足牛儿
邾	𠂉木阝
氚	气川
俷	亻月巴
譕	言𠂉廿廿火
瓿	立口瓦
潢	氵廿由八
漷	氵亠口子阝
辶	之
禳	示衣口口甘
鬻	弓米弓一口冂八丁
綆	糸一日乂
彘	彑匕矢匕
殛	一夕了口又一
殛	一夕丂口又一
堊	亞土
琵	王王匕匕
頊	王頁
拮	扌士口
枡	木丿廾
砟	石𠂉匕
骱	骨亻八
笸	竹匚口
頷	亼㇕口頁
鋃	金丶艮
狻	犭厶八夂
鴇	匕十鳥
鴟	氏一鳥
鴟	氏丶鳥
邙	亡阝
悌	心弋弓
淠	氵田廾
嫫	女艹日大
妣	女匕匕
餮	一夕人彡食
赳	走凵
埽	土彐冖巾
圾	土𠂊又
荖	艹耂匕
薅	艹女辰寸
樗	木雨一丂
樗	木雨丂一
柞	木𠂉匕
欹	大丁口欠
蠼	虫目目隹又
跆	足厶口
嗐	口宀丰口
黙	田土犬火
嵯	山羊工
牝	牛匕
怹	亻也心
鏑	金亠八冂十口
瘛	疒丰刀心
巻	半巳
懌	心四土半
瀞	氵丰月爪尹
瀞	氵丰月𠂊尹
漵	氵亼木攵
漈	氵䏑又示
滂	氵亠八冖方
繻	糸雨而
糶	屮凵米习习隹
嫘	女田糸
橛	木厂䒑屮欠
骺	骨𠂆一口
笊	竹爪
倀	亻長
倜	亻用口
皈	白厂又
皈	白𠂆又
鈳	金丁口
鯛	魚用口
怙	心十口
滹	氵虎爪丁
蔠	艹糸夂冫
撃	車殳手
槁	木亠口冂口
酃	雨口口口阝
奩	大匚口口口
鴯	而鳥
郾	匚日女阝
畋	田攵
髀	骨鬼十
穰	禾衣口口甘
獗	犭厂䒑屮欠
謅	言勹屮勹屮
癭	疒貝貝女
羰	羊山𠂇火
愴	心人户口
窬	穴亼月刂
窬	穴亼月巛
嬿	女廿口北火
砉	丰石
抉	扌㇕大
莩	艹爪子
迣	之廿乚
柩	木匚𠂊丶
蚰	虫由
螳	虫小冖口土
蛑	虫厶牛
咆	口勹巳
篋	竹匚大人人
価	亻西
翕	亼口习习
郄	乂𠂇厶阝
朐	月勹口
夤	夕宀一由八
窳	穴瓜瓜
劼	士口力
踅	扌斤足
蘧	艹之虎豕
杼	木予
磽	石土土土兀
鳪	卜鳥
蚋	虫冂人
跗	足亻寸
侔	亻厶牛
艚	舟一曲日
郇	勹日阝
裎	衤口王
裎	衤口亻土
冢	冖豕
陔	阝亠凵人
埵	土千艹二
瑭	王广尹口
醺	酉千四二火
喟	口田月
咐	口亻寸
蜚	非虫
旯	日九
嶙	山米夕㐄
甥	生田力
篾	竹四戈人
皤	白釆田
敫	白方攵
鵜	弋弓鳥
洄	氵圍口
裟	氵小丿衣
弭	弓耳
媾	女甘冂土
緡	糸巳七日
莨	艹丶艮
櫺	木雨口口口
霹	雨尸口辛
邳	不一阝
蟪	虫一日厶心
歳	止戊一小
蚣	虫八厶
跎	足宀匕
呉	口乚廾
嶝	山癶一口䒑
嶁	山婁
郃	亼口阝
貘	豸艹日大
読	言士冖儿
紶	糸土厶
婞	女土半
靑	丰冂丨一
苾	艹弋八
霑	雨氵卜口
蝽	虫丰日
犧	牛羊禾戈丂
恂	心勹日
夬	㇕大
翮	一口冂八丁习习
両	一冂山
邴	一冂人阝
玠	王亻八
蕤	艹豕生
鷯	一火日小鳥
蚱	虫𠂉匕
趵	足勹丶
帰	刂彐冖巾
罟	四十口
矍	目目隹又
峋	山勹日
嶋	山鳥
髏	骨婁
嚳	臼乂乂冖牛口
皁	白十
齎	齊貝
萆	艹鬼十
槔	木白大十
磴	石癶一口䒑
蟣	虫幺幺戈人
畛	田人彡
岈	山牙
犍	牛廴彐キ
釤	金彡
臃	月亠乚凵隹
譖	言旡旡日
廛	广田土八土
愎	心𠂉日夂
茚	艹臼卩
軛	車厂卩
匴	匚竹目廾
曩	日衣口口甘
暾	日亠口子攵
罱	四十冂半
岵	山十口
畬	亼木田
粢	二欠米
粢	冫欠米
庀	广匕
湎	氵頁圍
鐾	尸口辛金
総	糸八厶心
炱	厶口火
墻	土土人人圍口
摜	扌母貝
苜	艹目
硨	石車
錁	金田木
窆	穴丿之
聴	耳十四心
瑠	王卯田
搧	扌户习习
藿	艹雨隹
薱	艹业羊寸
葰	艹亻厶八夂
茭	艹亠八乂
菑	艹巛田
霎	雨立女
蛺	虫大人人
蜿	虫宀夕卩
昃	日厂人
簸	竹甘廾皮
佹	亻𠂊厂卩
儕	亻齊
剣	亼口人刂
艋	舟子皿
齏	齊非一
鶿	䒑幺幺鳥
炆	火文
惋	心宀夕卩
湓	氵八刀皿
褆	衤日一止
蓁	艹丰禾
萣	艹宀一止
柊	木夂冫
泅	氵圍人
紱	糸犬丿
紱	糸犬㇕
擯	扌宀一癶貝
搡	扌又又又木
帯	廿冖巾
酹	酉爪寸
雩	雨一丂
雩	雨丂一
靂	雨厂禾禾止
兕	圍凵儿
帙	巾手丶
簌	竹木口欠
穂	禾一由心
僂	亻婁
鄱	釆田阝
獍	犭立日儿
廩	广亠圍口禾
瀠	氵火火冖糸
韝	㐄口㐄甘冂土
顙	又又又木頁
綈	糸弋弓
堝	土咼
辻	之十
蔵	艹戊臣
晷	日夂卜口
筇	竹工阝
賃	亻工一貝
賃	亻丿士貝
鐙	金癶一口䒑
脒	月米
炻	火石
泔	氵甘
専	一由寸
墀	土尸水牛
挈	丰刀手
玹	王亠幺
騅	馬隹
嘏	十口尸二コ又
蓽	艹甲艹二
転	車二厶
弍	弋二
蟯	虫土土土兀
圏	圍半巳
豊	曲一口䒑
衄	丿皿彐丨
儻	亻小冖口四土火
儻	亻小冖口田土火
狆	犭中
痤	疒人人土
塋	火火冖土
煢	火火冖乙十
惇	心亠口子
溲	氵臼丨又
鷚	习习人彡鳥
丌	廾
掾	扌彑豕
萩	艹禾火
崤	山乂𠂇月
仃	亻丁
倗	亻月月
鈁	金方
艏	舟八頁
狷	犭口月
肷	月欠
鯖	魚丰月
麋	鹿米
逶	之禾女
辺	之刀
縲	糸田糸
絎	糸行
銎	工凡金
鞔	革召儿
櫨	木虎田皿
瓠	大一丂瓜
瓠	大丂一瓜
蚯	虫丘
圇	圍亼冊
圊	圍丰月
蹕	足甲艹二
罨	四大申
簹	竹小冖口田
簋	竹艮皿
氘	气刂
邉	之自穴口
徦	行尸二コ又
艄	舟小月
煺	火之艮
泚	氵止匕
湝	氵匕匕白
褳	衤之車
璠	王釆田
夼	大川
蠕	虫雨而
蹼	足业半大
暌	日癶一大
眇	目小丿
儐	亻宀一癶貝
鈽	金𠂇巾
釙	金卜
詆	言氏一
詆	言氏丶
馘	八頁戈口一
襦	衤雨而
遢	之日习习
逡	之厶八夂
婼	女艹𠂇口
縟	糸辰寸
鬲	一口冂八丁
殫	一夕口口甲一
螫	土火攵虫
騕	馬西女
藶	艹厂禾禾止
酩	酉夕口
砘	石丿屮
砘	石一屮
戢	口耳戈
噦	口止戊一癶
躂	足之土羊
跩	足申丿
旰	日干
篳	竹甲艹二
鍑	金𠂉日夂
鎪	金臼丨又
脳	月⺍乂凵
鴝	勹口鳥
応	广心
愬	䒑屮月心
滎	火火冖水
濞	氵自田廾
窶	穴婁
穸	穴夕
弾	弓⺍甲一
薍	艹爪龴冂厶龴乚
蔟	艹方𠂉矢
蕖	艹氵匚コ木
硭	石艹亡
吲	口弓丨
氙	气山
璺	臼冂一口冖王丶
鷦	隹火鳥
徂	行且
錆	金丰月
刎	勿刂
燔	火釆田
洸	氵小兀
瀵	氵米田艹廾
宬	宀戊㇕
綪	糸丰月
玦	王㇕大
蔞	艹婁
繋	車殳糸
榿	木山一口䒑
硇	石囟
跬	足土土
牸	牛宀子
簑	竹衣口一
仮	亻厂又
仮	亻𠂆又
傛	亻穴人口
辵	彡止
舾	舟西
颺	風日一勿
膾	月亼四日
憮	心𠂉廿廿火
泐	氵阝力
褸	衤婁
衽	衤工一
衽	衤丿士
闘	門一口䒑寸
擘	尸口辛手
綞	糸千艹二
縑	糸禾禾彐
鵡	戈止鳥
玢	王八刀
喥	口广廿又
笹	竹廿乚
篔	竹口貝
餞	食戈戈
錟	金火火
舯	舟中
隈	阝田衤
戞	一白冖戈
薤	艹一夕非一
剽	西示刂
僰	木冂木冂人
枇	木匕匕
砝	石土厶
劌	止戊一癶刂
蟈	虫圍戈口一
囹	圍亼卩
囹	圍亼龴
罾	四八四日
罾	四八田日
笓	竹匕匕
佧	亻上卜
俜	亻由丂
仡	亻𠂉乙
儋	亻𠂊厂八言
舳	舟由
胙	月𠂉匕
愜	心匚大人人
沬	氵二木
潒	氵召豕
瀼	氵衣口口甘
鄆	冖車阝
叚	尸二コ又
隠	阝爪彐心
垓	土亠凵人
枸	木勹口
蝟	虫田月
秫	禾木丶
秫	禾十儿丶
笶	竹矢
餑	食十冖子
愆	行氵心
猊	犭臼儿
詛	言且
瘩	疒艹亼口
疥	疒亻八
迢	之召
隰	阝日幺幺火
畚	厶大田
甏	士口䒑彡瓦
堠	土亻コ矢
醅	酉立口
椛	木艹亻匕
輅	車夂口
梃	木廴工一
梃	木廴丿士
梃	木廴亻土
霊	雨二业
曌	日月穴工
舎	人土口
涘	氵厶矢
哿	力口丁口
珙	王艹廾
葚	艹甘匚儿
葚	艹甘匚八
蒝	艹厂白小
萑	艹隹
櫝	木士四貝
蚺	虫冂土
螄	虫丿㠯一巾
蚍	虫匕匕
嶇	山匚口口口
幗	巾圍戈口一
筌	竹人王
鵂	亻木鳥
鴒	亼卩鳥
鴒	亼龴鳥
謳	言匚口口口
痌	疒冂一口
愾	心气米
捯	扌至刂
摭	扌广廿火
葜	艹丰刀大
榦	十日十人木
藁	艹亠口冂口木
醢	酉𠂇口皿
喞	口白匕卩
屼	山兀
烀	火爪丁
繴	尸口辛糸
紇	糸𠂉乙
絯	糸亠凵人
坼	土斤丶
柟	木冂土
巰	一巛工亠厶川
鬯	乂凵匕
鐠	金立立日
鯃	魚二乂口
鯃	魚工㇕口
糅	米予丿木
嫗	女匚口口口
鬨	鬥艹廾
嶅	士方攵山
嶅	土方攵山
嶅	丰力攵山
騮	馬卯田
莠	艹禾㇕丿
茳	艹氵工
暁	日十艹兀
偅	亻千日土
錡	金大丁口
鏹	金弓口虫
鏹	金弓厶虫
亀	龜
鶼	禾禾彐鳥
烜	火二日
湁	氵扌亼口
袼	衤夂口
甓	尸口辛瓦
乸	也母
紾	糸人彡
螂	虫丶艮阝
暹	之日隹
帔	巾皮
佾	亻八月
肜	月彡
胳	月夂口
瘠	疒⺍人月
翥	耂习习
聃	耳冂土
髟	長彡
栢	木一白
酡	酉宀匕
櫧	木言耂
杷	木巴
篠	竹亻丨夂木
篠	竹亻丨攵木
箛	竹子瓜
鋏	金大人人
鐓	金亠口子攵
凪	几止
颶	風目廾
糀	米艹亻匕
淰	氵亼㇕心
滃	氵八厶习习
済	氵齊
湴	氵立立
鷥	糸糸鳥
琯	王宀㠯
卌	一刂刂
艨	舟艹冖一豕
誃	言夕夕
慄	心西木
鵓	十冖子鳥
薷	艹雨而
萢	艹氵勹巳
楛	木艹十口
櫬	木立木見
柁	木宀匕
黠	四土火士口
黠	田土火士口
迕	之午
観	𠂉一隹見
稲	禾爪丨日
俓	亻一巛工
鵯	鬼十鳥
偓	亻尸至
鄯	羊䒑口阝
悕	心乂𠂇巾
悩	心⺍乂凵
澪	氵雨亼卩
澪	氵雨亼龴
滏	氵八乂王八
寛	宀艹見
襝	衤亼口口人人
険	阝亼口人
醵	酉虎豕
碣	石日勹亡
晡	日甫
矬	矢人人土
篼	竹白卯儿
徉	行羊
舴	舟𠂉匕
鷄	爪幺大鳥
胩	月上卜
狒	犭弓刂
訳	言尸丶
麂	鹿几
忉	心刀
蓜	艹酉巳
囔	口一中冖口口甘衤
躒	足白幺幺木
唦	口氵小丿
噉	口丁耳攵
噉	口㇕耳攵
畎	田犬
乗	千艹木
毽	毛廴彐キ
脿	月丰衤
忔	心𠂉乙
熸	火旡旡日
湉	氵心舌
緶	糸亻一日乂
孌	言糸糸女
纛	丰母目木丿糸
荘	艹爿士
豳	豕豕山
幄	巾尸至
徼	行白方攵
猖	犭日日
鰩	魚爪午凵
鰩	魚䏑午凵
癍	疒王文王
悱	心非
湞	氵卜貝
孱	尸子子子
謦	士尸殳言
柙	木甲
雫	雨下
嚧	口虎田皿
瞠	目小冖口土
覬	山一口䒑見
侏	亻𠂉木
戧	人户口戈
効	亠八乂力
焜	火日匕匕
屮	屮
坩	土甘
琤	王爪尹
琤	王𠂊尹
菝	艹扌犬丿
菝	艹扌犬㇕
茯	艹亻犬
蒍	艹爲
蓿	艹宀亻一白
戡	甘匚儿戈
戡	甘匚八戈
蜻	虫丰月
圄	圍二乂口
圄	圍工㇕口
筘	竹扌口
簦	竹癶一口䒑
僨	亻十艹貝
鍰	金爪一𠂇又
猾	犭骨
冲	冫中
戕	爿戈
痊	疒人王
渫	氵廿乚木
洶	氵勹乂凵
迹	之大八
疋	足
隍	阝白王
鬣	長彡巛圍乂巛
耩	耒甘冂土
駅	馬尸丶
抜	扌𠂇又
揺	扌爪干凵
蓶	艹口隹
茽	艹亻中
蕹	艹亠乚凵隹
蓙	艹广人人土
薬	艹白⺍木
槸	木土儿土丸
槸	木土八土丸
醍	酉日一止
轆	車鹿
麮	木人人夂土厶
桷	木𠂊用
歴	厂木木止
尥	尤勹丶
噱	口虎豕
唿	口勿心
禸	冂厶
黝	四土火幺力
黝	田土火幺力
缽	午凵木一
傕	亻冖隹
従	行䒑止
敓	八口儿攵
鋝	金爪寸
蠃	亡口月虫凡
庢	广至
瘞	疒大人人土
痋	疒虫
燿	火习习隹
漃	氵宀上小又
縌	糸之䒑屮
郷	乚凵艮阝
抔	扌不
椹	木甘匚儿
椹	木甘匚八
柢	木氏一
柢	木氏丶
呴	口勹口
蹉	足羊工
銭	金二戈
鰥	魚四水
愔	心立日
溻	氵日习习
漯	氵田糸
窀	穴丿屮
窀	穴一屮
堔	土冖儿木
堔	土冖八木
騸	馬户习习
軹	車口八
貲	止匕貝
翾	四一口衤习习
鐃	金土土土兀
廋	广臼丨又
鷓	广廿火鳥
痾	疒阝丁口
糢	米艹日大
惔	心火火
襘	衤亼四日
陘	阝一巛工
紟	糸亼㇕
璵	王臼一乚丨廾
萋	艹一尹女
豨	豕乂𠂇巾
崦	山大申
坌	八刀土
鯧	魚日日
恛	心圍口
洣	氵米
邂	之𠂊用刀牛
繢	糸中一貝
廾	廾
蓍	艹耂匕日
榀	木口口口
檁	木亠圍口禾
榍	木尸小月
磔	石夕㐄木
嗏	口艹人木
峇	山亼口
岌	山𠂊又
笢	竹巳七
皛	白白白
舨	舟厂又
舨	舟𠂆又
亶	亠圍口日一
癯	疒目目隹
焼	火十艹兀
滈	氵亠口冂口
滝	氵立申
褟	衤日习习
嫿	女彐キ田一
菥	艹木斤
菖	艹日日
栳	木耂匕
杌	木兀
椥	木矢口
桴	木爪子
螓	虫丰禾
跽	足巳心
筅	竹牛儿
逭	之宀㠯
廻	廴圍口
弖	弓一
紿	糸厶口
嚭	士口䒑口不口
赧	土火卩又
鋆	土勹冫金
鋆	土勹二金
贄	土半丸貝
鬘	長彡日四又
鬘	長彡冖二四又
騶	馬勹屮勹屮
葺	艹口耳
莛	艹廴工一
莛	艹廴丿士
莛	艹廴亻土
酔	酉九十
検	木亼口人
呺	口口丂
敤	田木卜又
幛	巾立日十
剴	山一口䒑刂
籜	竹扌四土半
働	亻千日土力
舥	舟巴
腙	月宀示
斎	齊示
汩	氵圍一
禤	示四习习
劦	力力力
妺	女一木
媔	女頁圍
胬	女又䏑
儿	儿
玷	王卜口
琲	王非
萠	艹月月
蔇	艹艮旡
栖	木西
柝	木斤丶
砵	石木一
嚅	口雨而
箝	竹扌甘
凭	亻工一几
凭	亻丿士几
佝	亻勹口
徥	行日一止
疔	疒丁
堍	土召儿丶
埌	土丶艮
髑	骨四勹虫
穏	禾爪彐心
僤	亻口口甲一
仫	亻丿厶
傯	亻囟夂心
傯	亻囟丿乂心
颮	風勹巳
韵	立日勹冫
韵	立日勹二
翫	习习白一兀
彅	弓䒑月刂刀
嬬	女雨而
馹	馬日
檎	木人亠乂凵冂厶
踊	足龴用
魡	魚勹丶
懨	心厂日月犬
澔	氵白牛口
渢	氵風
幇	土土寸巾
髭	長彡止匕
珎	王𠂉小
珎	王𠂊小
珎	王竹八
虆	艹田田田糸
槇	木匕目廾
囲	圍二刂
暀	日行丶王
儚	亻艹四冖夕
傖	亻人户口
偝	亻北月
糴	人米习习隹
鐔	金西日十
肭	月冂人
狍	犭勹巳
匐	勹一口田
謌	言丁口丁口
懐	心亠四衣
漖	氵耂子攵
獣	⺍田一口犬
鼡	⺍几キ
濆	氵十艹貝
戻	户大
陲	阝千艹二
牁	爿丁口
繲	糸𠂊用刀牛
坻	土氏一
坻	土氏丶
掟	扌宀一止
嚏	口十冖田足
佻	亻儿⺍
敉	米攵
汸	氵方
陬	阝耳又
驂	馬厶厶厶人彡
悊	扌斤心
薫	艹千日土火
蕝	艹糸𠂊巴
厎	厂氏一
厎	厂氏丶
覘	卜口見
呰	止匕口
嗞	口䒑幺幺
鸀	四勹虫鳥
甡	生生
盥	臼水皿
躱	身㇕丿木
仳	亻匕匕
欷	乂𠂇巾欠
鍜	金尸二コ又
魼	魚土厶
斉	齊
慬	心艹口丰
慬	心廿口丰
営	⺍冖口口
営	⺍冖口丿口
栄	⺍冖木
汔	氵𠂉乙
乀	丶
荽	艹爪女
桎	木至
蜞	虫甘廾
蛸	虫小月
盱	目丁一
溷	氵圍豕
袈	力口衣
覡	工人人見
攖	扌貝貝女
蝲	虫木口刂
蝂	虫爿厂又
蝂	虫爿𠂆又
囷	圍禾
趼	足一廾
嘽	口口口甲一
簭	竹工人人八口
鐖	金幺幺戈人
脕	月召儿
夐	𠂊冂人目夂
弚	八丨弓
澥	氵𠂊用刀牛
扃	户冂口
拏	女又手
耜	耒㠯
茛	艹艮
叶	口十
喰	口食
眚	生目
徭	行爪午凵
徭	行䏑午凵
胴	月冂一口
觚	𠂊用瓜
繯	糸四一口衤
壢	土厂禾禾止
蒎	艹氵𠂆亻
靉	雨二厶爪冖心夂
樋	木之龴用
鵪	大申鳥
蝰	虫大土土
氅	小冂口攵毛
晩	日召儿
黥	四土火亠口小
黥	田土火亠口小
嵫	山䒑幺幺
贔	貝貝貝
倶	亻目廾
鰣	魚日土寸
訐	言干
旂	方𠂉斤
斿	方𠂉子
邶	北阝
犖	火火冖牛
溦	氵山一几攵
窞	穴𠂊臼
紒	糸亻八
堞	土廿乚木
聒	耳舌
蹂	足予丿木
笂	竹丸
箹	竹糸勹丶
僬	亻隹火
猙	犭爪尹
鰈	魚廿乚木
袱	衤亻犬
遴	之米夕㐄
纊	糸广廿由八
紼	糸弓刂
壚	土虎田皿
愨	士冖一殳心
駙	馬亻寸
蘀	艹扌四土半
蓐	艹辰寸
蔀	艹立口阝
軽	車又土
嘂	口口凵口口
巋	山丿㠯止彐冖巾
嵂	山行彐キ
徴	行山王攵
郤	八人口阝
鏝	金日四又
鏝	金冖二四又
瘕	疒尸二コ又
滒	氵丁口丁口
叕	又又又又
璫	王小冖口田
莃	艹乂𠂇巾
樻	木中一貝
嗾	口方𠂉矢
舄	臼勹火
疸	疒日一
悝	心田土
殂	一夕且
迋	之王
墼	車凵殳土
楀	木丿口冂厶
奭	大一白一白
臸	至至
蜩	虫用口
鴞	口丂鳥
黼	业巾⺍甫
嵖	山木日一
睺	目亻コ矢
侀	亻一廾刂
鋱	金弋心
鉯	金厶人
塱	丶艮月土
頖	半頁
憍	心丿大口冂口
悾	心穴工
忸	心彐丨
滆	氵一口冂八丁
浭	氵一日乂
潵	氵廿月攵
洊	氵一亻子
浥	氵口巴
迡	之尸匕
妁	女勹丶
毐	士母丿
捩	扌户犬
捩	扌户大
奓	大夕夕
哫	口足
鯓	魚身
渼	氵羊大
紘	糸𠂇厶
豌	一口䒑宀夕卩
駘	馬厶口
頼	木口頁
蹚	足小冖口土
躊	足士㇕工一口寸
嚜	口四土火土
嚜	口田土火土
毘	田匕匕
嶆	山一曲日
簬	竹足夂口
犵	犭𠂉乙
鮱	魚耂匕
讞	言虎一口冂八丁犬
剤	齊刂
竑	立𠂇厶
瀡	氵阝之𠂇工月
顁	宀一止頁
衯	衤八刀
襞	尸口辛衣
姉	女亠巾
姉	女一巾
彖	彑豕
姙	女亻工一
姙	女亻丿士
帑	女又巾
髹	長彡亻木
揶	扌耳阝
呬	口四
瞌	目土厶皿
鼯	臼釆二乂口
鼯	臼釆工㇕口
猱	犭予丿木
縻	广木木糸
縻	广十儿十儿糸
怦	心干八
忡	心中
渋	氵止氵
洫	氵丿皿
濘	氵宀心皿丁
榖	士冖一木殳
甍	艹四冖瓦
蒗	艹氵丶艮
櫞	木糸彑豕
蝮	虫𠂉日夂
嗼	口艹日大
呪	口口儿
嶒	山八四日
嶒	山八田日
顗	山一口䒑頁
歓	𠂉一隹欠
龠	亼口口口冊
痍	疒大弓
懣	氵廿巾人人心
渟	氵亠口冖丁
褦	衤厶月匕匕
娸	女甘廾
嬢	女衣八甘
邗	干阝
堙	土西土
抨	扌干八
蝌	虫禾冫十
哘	口行
矓	目龍
臾	臼人
螣	月半虫
夌	土儿夂
夌	土八夂
瑢	王穴人口
鞞	革鬼十
蕓	艹雨二厶
剞	大丁口刂
綔	大一丂丿糸
綔	大丂一丿糸
囮	圍亻匕
眄	目丁乚㇕
嶈	山爿䏑寸
黐	禾人水亠乂凵冂厶
懞	心艹冖一豕
湡	氵日冂厶
淆	氵乂𠂇月
沆	氵亠几
袙	衤白
姤	女𠂆一口
鬈	長彡半卩
酗	酉乂凵
篝	竹甘冂土
穠	禾曲辰
伉	亻亠几
徜	行小冂口
貊	豸一白
悃	心圍木
継	糸米乚
扞	扌干
蕻	艹長艹廾
蒶	艹糸八刀
唖	口亞
賅	貝亠凵人
睽	目癶一大
箅	竹田廾
傜	亻爪午凵
傜	亻䏑午凵
鏚	金戊上小
臌	月士口䒑十又
犴	犭干
匍	勹甫
瘌	疒木口刂
曽	八田日
濋	氵木木足
潕	氵𠂉廿廿火
戣	癶一大戈
姮	女二日
塄	土四方
桄	木小兀
吁	口丁一
佴	亻耳
仉	亻几
湲	氵爪一𠂇又
祓	示犬丿
祓	示犬㇕
紲	糸廿乚
垜	土㇕丿木
齧	丰刀齒
栫	木一亻子
枘	木冂人
権	木𠂉一隹
檞	木𠂊用刀牛
刳	大一丂刂
刳	大丂一刂
犒	牛亠口冂口
剰	千艹木刂
秕	禾匕匕
佌	亻止匕
鯪	魚土儿夂
鯪	魚土八夂
癘	疒艹日冂厶
粄	米厂又
粄	米𠂆又
炘	火斤
悢	心丶艮
湅	氵木四
礽	示㇕丿
皯	皮干
薠	艹火頁
芓	艹子
喁	口日冂厶
稞	禾田木
皞	白白大十
鯗	羊魚
悒	心口巴
忑	下心
縶	土半丸糸
瓘	王艹口口隹
聡	耳八厶心
鞚	革穴工
榎	木頁夂
槻	木夫見
鄲	口口甲一阝
黟	四土火夕夕
黟	田土火夕夕
鎹	金之䒑大
濇	氵土人人圍口
労	⺍冖力
汭	氵冂人
扆	户衣
隩	阝宀米大
繐	糸一日厶心
娩	女召儿
搠	扌䒑屮月
枵	木口丂
螈	虫厂白小
睥	目鬼十
臬	自木
傺	亻䏑又示
邠	八刀阝
鮞	魚而
鰷	魚亻丨夂木
鰷	魚亻丨攵木
鯇	魚宀一兀
沚	氵止
澠	氵黽
瑨	王一业日
瑨	王二厶厶日
耬	耒婁
挻	扌廴丿止
靺	革一木
葃	艹日𠂉匕
屺	山巳
迮	之𠂉匕
脡	月廴工一
脡	月廴丿士
脡	月廴亻土
朓	月儿⺍
痩	疒申又
巣	⺍田木
挲	氵小丿手
祆	示一大
芞	艹气
茌	艹亻士
栝	木舌
螃	虫亠八冖方
昪	日厶廾
幘	巾丰貝
儇	亻四一口衤
獷	犭广廿由八
嫄	女厂白小
殧	一夕亠口小尤
丼	二刂丶
墁	土日四又
墁	土冖二四又
捜	扌申又
鞨	革日勹亡
欐	木一冂丶一冂丶鹿
磡	石甘匚儿力
磡	石甘匚八力
覧	臣𠂉丶見
覧	臣𠂉一見
歔	虎业欠
歔	虎丘欠
艶	曲一口䒑𠂊巴
髎	骨习习人彡
黌	臼乂乂冖廿由八
躰	身木一
鱧	魚曲一口䒑
麈	鹿丶王
淏	氵日一大
禊	示丰刀大
烝	㇕水一火
纋	糸一白冖心夂
繰	糸口口口木
趔	走一夕刂
玡	王牙
掊	扌立口
蟋	虫釆心
迚	之中
暐	日㐄口㐄
毳	毛毛毛
儰	亻艹爲
錬	金木日
鱖	魚厂䒑屮欠
訇	勹言
汚	氵丂一
陴	阝鬼十
紑	糸不
犛	二木攵厂牛
埴	土十目
搐	扌亠幺田
藸	艹豕耂
蒛	艹午凵㇕大
蕅	艹氵日冂厶
軔	車刀丶
靦	頁圍見
蛯	虫耂匕
喨	口亠口冖几
黻	业巾⺍犬丿
黻	业巾⺍犬㇕
鍚	金日一勿
凖	冫隹十
廨	广𠂊用刀牛
瘳	疒习习人彡
鶺	⺍人月鳥
滻	氵立丿生
窓	穴厶心
屨	尸行婁
騭	阝止癶馬
婠	女宀㠯
孥	女又子
埤	土鬼十
琊	王牙阝
晢	扌斤日
呣	口母
昜	日一勿
籀	竹扌卯田
媵	月半女
癶	癶
覿	士四貝見
騒	馬又虫
揄	扌亼月刂
揄	扌亼月巛
拶	扌巛夕
萏	艹𠂊臼
覇	西革月
厓	厂土土
躇	足艹耂
簀	竹丰貝
偭	亻頁圍
儡	亻田田田
侘	亻宀丿七
勍	亠口小力
纀	糸亻业半大
圬	土一丂
圬	土丂一
垳	土行
搛	扌禾禾彐
楯	木𠂆十目
椈	木勹米
尨	尤彡
銚	金儿⺍
痦	疒二乂口
痦	疒工㇕口
懮	心一白冖心夂
氶	㇕水
塩	土𠂉口皿
蒨	艹亻丰月
樨	木尸水牛
崕	山厂土土
巉	山召匕匕召儿丶
犠	牛羊手戈
笅	竹乂乂
弇	亼口廾
貅	豸亻木
舭	舟匕匕
廆	广鬼
怍	心𠂉匕
愮	心爪午凵
愮	心䏑午凵
悛	心厶八夂
滀	氵亠幺田
寘	宀十目廾
寘	宀匕目廾
夛	彐夕
彑	彑
亏	一丂
垎	土夂口
蒴	艹䒑屮月
柃	木亼卩
柃	木亼龴
鉒	金丶王
魨	魚丿屮
魨	魚一屮
鯡	魚非
邡	方阝
沋	氵尤
氿	氵九
絪	糸圍大
紝	糸工一
紝	糸丿士
纘	糸牛儿牛儿貝
墠	土口口甲一
塲	土𠂉日一勿
駆	馬匚乂
撟	扌丿大口冂口
蔌	艹木口欠
瞢	艹四冖目
雱	雨方
砕	石九十
啁	口用口
岠	山匚コ
簨	竹巳巳艹廾
俉	亻二乂口
俉	亻工㇕口
翛	亻丨夂习习
翛	亻丨攵习习
傝	亻日习习
垕	𠂆一口土
艟	舟立田土
誋	言巳心
冴	冫牙
怩	心尸匕
滉	氵日小兀
沴	氵人彡
浄	氵𠂊尹
澉	氵丁耳攵
澉	氵㇕耳攵
衧	衤丁一
阼	阝𠂉匕
牂	爿羊
姞	女士口
垧	土宀口
逹	之土半
栭	木而
砒	石匕匕
狃	犭彐丨
澌	氵甘廾斤
綮	户攵糸
趄	走且
絜	丰刀糸
掭	扌一大心
戁	廿口夫隹心
戁	艹口夫隹心
茺	艹亠厶儿
螻	虫婁
崋	山一艹キ
覦	亼月刂見
覦	亼月巛見
庣	广儿⺍
烺	火丶艮
熻	火亼口习习
潸	氵木木月
沕	氵勿
褑	衤爪一𠂇又
繖	糸廿月攵
孋	女一冂丶一冂丶鹿
妢	女八刀
檉	木耳口王
檉	木耳口亻土
霪	雨氵爪工一
霪	雨氵爪丿士
尪	尤王
崟	山金
呑	丿大口
玀	犭四糸隹
瘥	疒羊工
怫	心弓刂
褙	衤北月
隣	阝米夕㐄
郪	一尹女阝
耋	耂匕至
珧	王儿⺍
遘	之甘冂土
蕺	艹口耳戈
椀	木宀夕卩
剄	一巛工刂
慝	匚艹𠂇口心
嗛	口禾禾彐
牾	牛二乂口
牾	牛工㇕口
侉	亻大一丂
侉	亻大丂一
倓	亻火火
脰	月一口䒑
賸	月半貝
鰰	魚示申
憡	心竹木冂
烔	火冂一口
燠	火宀米大
濊	氵止戊一癶
遅	之尸羊
闀	門艹廾巳
婗	女臼儿
紕	糸匕匕
殪	一夕士冖一口䒑
掤	扌月月
葸	艹田心
貰	廿乚貝
蓊	艹八厶习习
柈	木半
楗	木廴彐キ
划	戈刂
匜	匚也
躔	足广田土八土
伾	亻不一
瑆	王日生
皵	廿日皮
茇	艹犬丿
茇	艹犬㇕
蕆	艹戊貝
棬	木半卩
簕	竹革力
傒	亻爪幺大
獼	犭弓一八巾乂乂乂乂
卆	九十
袤	衣予丿
悗	心召儿
洑	氵亻犬
瀷	氵习习田艹廾
祌	示中
褘	衤㐄口㐄
韡	㐄口㐄華
縴	糸亠幺冖牛
瑝	王白王
葎	艹行彐キ
椚	木門
礴	石艹氵甫寸
賻	貝甫寸
鯠	魚木人人
鄜	鹿阝
忕	心大
屣	尸行止止
翬	习习冖車
圷	土下
酤	酉十口
柷	木口儿
躅	足四勹虫
昺	日一冂人
罍	田田田午凵
傋	亻甘冂土
俙	亻乂𠂇巾
脙	月十⺍丶
肄	匕矢彐キ
麿	广木木口口
麿	广木木口丿口
麿	广十儿十儿口口
麿	广十儿十儿口丿口
癔	疒立日心
蛍	⺍冖虫
湳	氵十冂半
濈	氵口耳戈
祅	示丿大
丮	乙キ
縁	糸彐豕
璿	王卜冖一八人目
睚	目厂土土
癿	白乚
鱒	魚八酉寸
瘙	疒又冫虫
瘙	疒又丶虫
忪	心八厶
阯	阝止
娠	女辰
覯	甘冂土見
蕢	艹中一貝
棼	木木八刀
欑	木牛儿牛儿貝
蜴	虫日勿
躕	足广士口䒑寸
甁	丿干丿干瓦
簰	竹爿鬼十
侳	亻人人土
儴	亻衣口口甘
鄶	亼四日阝
鏐	金习习人彡
鰾	魚西示
迯	之夕卜
亰	亠日小
裒	衣臼
庤	广土寸
癃	疒阝夂一生
浘	氵尸毛
扂	户卜口
祫	示亼口
閺	門日文
臠	言糸糸䏑
挿	扌千日
棌	木爪木
歭	止土寸
蝙	虫户冊
戥	日生戈
忮	心十又
惈	心田木
襻	衤乂乂木木大手
褫	衤𠂆虎
禚	示羊火
掲	扌日勹匕
攛	扌穴臼釆
扱	扌𠂊又
鞎	革艮
唴	口羊儿
曚	日艹冖一豕
昳	日手丶
岼	山干八
礐	臼乂乂冖石
伋	亻𠂊又
鮀	魚宀匕
誸	言弓亠幺
庁	广丁
慲	心廿巾人人
慥	心之牛口
祧	示儿⺍
褕	衤亼月刂
褕	衤亼月巛
堥	予丿攵土
夃	㇕丿又
妧	女一兀
媺	女山一几攵
毿	厶厶厶人彡毛
拫	扌艮
搦	扌弓冫弓冫
砢	石丁口
籐	竹月半水
穜	禾立田土
倻	亻耳阝
癈	疒癶弓殳
漭	氵艹犬廾
襤	衤臣𠂉丶皿
襤	衤臣𠂉一皿
憙	士口䒑口心
趫	走丿大口冂口
瑱	王十目廾
瑱	王匕目廾
耱	耒广木木石
耱	耒广十儿十儿石
攮	扌一中冖口口甘衤
釃	酉一冂丶一冂丶鹿
嶌	山鳥
偛	亻千臼
犽	犭牙
羑	羊𠂊丶
怏	心冂大
灄	氵耳耳耳
洿	氵大一丂
洿	氵大丂一
渉	氵止小丿
潃	氵行夂月
瀙	氵立木見
戭	宀一由八戈
袛	衤氏一
袛	衤氏丶
綍	糸十冖子
嫜	女立日十
弆	土厶廾
捭	扌鬼十
栱	木艹廾
蜮	虫戈口一
蜢	虫子皿
舁	臼廾
仏	亻厶
鞤	土土寸革
塝	土亠八冖方
搣	扌戊一火
撹	扌⺍冖見
茪	艹小兀
棻	艹八刀木
酴	酉亼木
槧	車斤木
栴	木𠂉冊丶
翃	𠂇厶习习
歯	齒
嗕	口辰寸
嚌	口齊
秭	禾丿乚亻
畠	白田
夎	人人土夂
猻	犭子丿糸
譃	言虎业
譃	言虎丘
瘼	疒艹日大
涜	氵士冖儿
褓	衤亻口木
艸	屮屮
姏	女甘
垤	土至
哢	口王廾
簏	竹鹿
釢	金㇕丿
熲	匕火頁
癀	疒廿由八
鏖	鹿金
潲	氵禾小月
殠	一夕自犬
堣	土日冂厶
玕	王干
驫	馬馬馬
荄	艹亠凵人
薀	艹氵圍人皿
酲	酉口王
酲	酉口亻土
囫	圍勿
蹓	足卯田
罽	四厂火火刂
嶢	山土土土兀
崁	山土欠
崡	山丂⺍凵
崡	山了⺍凵
牤	牛亡
黧	禾丿刀四土火
黧	禾丿刀田土火
僸	亻木木示
劊	亼四日刂
钀	金虎一口冂八丁犬
銗	金𠂆一口
腄	月千艹二
脇	月力力力
脧	月厶八夂
孳	䒑幺幺子
涬	氵土半
厳	⺍厂丁耳攵
厳	⺍厂㇕耳攵
涴	氵宀夕卩
襁	衤弓口虫
襁	衤弓厶虫
闅	門目卜又
菤	艹半卩
莙	艹尹口
腠	月丰一大
腧	月亼月刂
腧	月亼月巛
鮪	魚𠂇月
瘰	疒田糸
疧	疒氏
疰	疒丶王
摽	扌西示
蕘	艹土土土兀
梺	木木下
檑	木雨田
輞	車冂䒑亡
霂	雨氵木
黷	四土火士四貝
黷	田土火士四貝
眈	目冖儿
犤	牛四厶月匕匕
儞	亻一八巾乂乂乂乂
敍	亼木卜又
衞	行㐄口一巾
飮	食卜欠
鐡	金十戈口䒑
脥	月大人人
亹	亠臼冂一口冖且
膂	方𠂉亻月
廃	广癶二儿
癉	疒口口甲一
愭	心耂匕日
褗	衤匚日女
衪	衤也
妯	女由
縼	糸方𠂉足
蓂	艹冖日亠八
篥	竹西木
簃	竹禾夕夕
儱	亻龍
螽	夂冫虫虫
爝	火爪四艮寸
垰	土上下
堨	土日勹亡
趠	走卜日十
拝	扌一丰
鞮	革日一止
酎	酉寸
暠	日亠口冂口
鼩	臼釆勹口
劓	自田廾刂
燐	火米夕㐄
涗	氵八口儿
漥	氵穴土土
袴	衤大一丂
袴	衤大丂一
襆	衤业半大
姺	女牛儿
娭	女厶矢
趲	走牛儿牛儿貝
払	扌厶
楢	木八酉
貺	貝口儿
艤	舟羊手戈
膻	月亠圍口日一
胼	月䒑廾
疻	疒口八
煇	火冖車
羼	尸羊羊羊
埏	土廴丿止
珷	王戈止
珽	王廴工一
珽	王廴丿士
珽	王廴亻土
驩	馬艹口口隹
騩	馬鬼
苖	艹由
蒢	艹阝亼木
栻	木弋工
齢	齒亼卩
齢	齒亼龴
喌	口口⺍川
嗿	口亼㇕貝
幪	巾艹冖一豕
嶉	山口隹
矧	矢弓丨
犦	牛日艹廾水
簷	竹𠂊厂八言
鼴	臼釆匚日女
魊	鬼戈口一
齁	自田廾勹口
偊	亻丿口冂厶
倞	亻亠口小
悆	亼木心
鍭	金亻コ矢
艂	舟夂丰
脟	月爪寸
虓	九虎
鰹	魚臣又土
褊	衤户冊
妀	巳女
繧	糸雨二厶
縄	糸黽
綎	糸廴工一
綎	糸廴丿士
綎	糸廴亻土
塏	土山一口䒑
垍	土自
琀	王亼㇕口
蒹	艹禾禾彐
磻	石釆田
匸	匚
躓	足斤斤貝
笘	竹卜口
貔	豸囟匕匕
獮	犭一八巾乂乂乂乂
鮓	魚𠂉匕
痼	疒圍十口
汧	氵一廾
涷	氵木日
窅	穴目
垗	土儿⺍
瑅	王日一止
藒	艹禾日勹亡
蓧	艹亻丨夂木
蓧	艹亻丨攵木
薸	艹氵西示
槙	木十目廾
椄	木立女
礅	石亠口子攵
跂	足十又
蹣	足廿巾人人
畤	田土寸
晫	日卜日十
黹	业巾⺍
賎	貝二戈
惣	牛勿心
皝	白王小兀
傞	亻羊工
衎	行干
諵	言十冂半
竝	立立
洢	氵亻尹
郿	尸目阝
姽	女𠂊厂卩
堷	土立日
珵	王口王
珵	王口亻土
捃	扌尹口
芼	艹毛
槤	木之車
柸	木不一
梏	木牛口
忐	上心
嘓	口圍戈口一
晧	日牛口
麇	鹿禾
潗	氵隹木
陜	阝大人人
弐	戈二
赬	土火卜貝
埆	土𠂊用
玞	王夫
駄	馬大丶
薢	艹𠂊用刀牛
厜	厂千艹二
厖	厂尤彡
劂	厂䒑屮欠刂
匼	匚亼口
蚡	虫八刀
崶	山土土寸
勲	千日土力火
蜑	廴丿止虫
傴	亻匚口口口
儵	亻丨夂四土火
儵	亻丨攵四土火
儵	亻丨夂田土火
儵	亻丨攵田土火
劒	亼口口人人刀丶
郛	爪子阝
颻	爪午凵風
颻	䏑午凵風
鵺	亠亻夂丶鳥
奨	爿爪寸大
湀	氵癶一大
灉	氵巛口巴隹
矞	予丿冂儿口
矞	予丿冂八口
娯	女口乚廾
邽	土土阝
択	扌尸丶
苠	艹巳七
蝣	虫方𠂉子
嚗	口日艹廾水
偁	亻爪冂土
狨	犭戈𠂇
訏	言丁一
諴	言戊一口
瀣	氵卜夕又非一
綝	糸木木
堎	土土儿夂
堎	土土八夂
壱	士冖匕
聹	耳宀心皿丁
捔	扌𠂊用
菍	艹亼㇕心
杮	木一巾
勅	木口力
輊	車至
栃	木𠂆一力
磙	石衣八厶
齮	齒大丁口
罣	四土土
瞴	目𠂉廿廿火
飳	食丶王
譫	言𠂊厂八言
遹	之予丿冂儿口
遹	之予丿冂八口
翯	习习亠口冂口
繍	糸尹川米
堧	土而大
捊	扌爪子
掮	扌户月
恧	而心
蜾	虫田木
咥	口至
辿	之山
詀	言卜口
蘾	艹土衣四水
蘞	艹亼口口人人攵
樫	木臣又土
睃	目厶八夂
頲	廴工一頁
頲	廴丿士頁
頲	廴亻土頁
怓	心女又
禔	示日一止
禘	示亠八冖巾
弸	弓月月
繘	糸予丿冂儿口
繘	糸予丿冂八口
莰	艹土欠
棈	木丰月
棤	木廿日
楩	木亻一日乂
枹	木勹巳
郫	鬼十阝
偟	亻白王
脽	月隹
獊	犭人户口
膷	月乚凵丶艮阝
膷	月乚凵艮阝
粺	米鬼十
掎	扌大丁口
靷	革弓丨
菉	艹彐水
橀	木亠厶川皿
碥	石户冊
躑	足八酉大阝
跕	足卜口
褁	田木衤
顕	日业頁
鷡	𠂉廿廿火鳥
甃	禾火瓦
篨	竹阝亼木
倷	亻大示
偍	亻日一止
鶲	八厶习习鳥
瓞	瓜手丶
獴	犭艹冖一豕
鮇	魚二木
炰	勹巳火
糬	米四耂
焮	火斤欠
泙	氵干八
挙	⺍廾手
洚	氵夂㐄
祔	示亻寸
闓	門山一口䒑
玗	王丁一
挵	扌王廾
棓	木立口
篚	竹匚非
銕	金大弓
瘵	疒䏑又示
惛	心氏日
棨	户攵木
駸	馬彐冖又
揵	扌廴彐キ
萭	艹丿口冂厶
藠	艹白白白
蔿	艹爲
藦	艹广木木手
藦	艹广十儿十儿手
榯	木日土寸
斝	口口冖冫十
暍	日日勹亡
賥	貝亠人人十
舲	舟亼卩
舲	舟亼龴
狚	犭日一
鰕	魚尸二コ又
怱	勿丶心
讃	言夫夫貝
癧	疒厂禾禾止
瘐	疒臼人
渃	氵艹𠂇口
浡	氵十冖子
涢	氵口貝
渕	氵䒑大刂
衶	衤中
擐	扌四一口衤
挼	扌爪女
莕	艹木口
葥	艹䒑月刂
栯	木𠂇月
桕	木臼
蚷	虫匚コ
咡	口耳
篌	竹亻コ矢
俥	亻車
脭	月口王
脭	月口亻土
狁	犭厶儿
鯔	魚巛田
訞	言丿大
埫	土小冂口
摛	扌亠乂凵冂厶
苨	艹尸匕
厰	厂小冂口攵
尰	尤千日土
躞	足言火火又
囃	口亠人人木隹
婓	非女
偢	亻禾火
鉶	金一廾刂
钁	金目目隹又
舺	舟甲
狌	犭生
頩	䒑廾頁
憱	心亠口小尤
隉	阝臼工
翋	习习立
姁	女勹口
嫋	女弓冫弓冫
喤	口白王
眳	目夕口
釭	金工
鋂	金𠂉母
洀	氵舟
湇	氵立月
祏	示石
墘	土十日十𠂉乙
逜	之二乂口
逜	之工㇕口
捽	扌亠人人十
揎	扌宀二日
轌	車雨彐
轢	車白幺幺木
吷	口㇕大
倂	亻丿干丿干
飜	釆田乙冫丿刂乙冫
釈	釆尸丶
臑	月雨而
猹	犭木日一
竷	立日十夂㐄夂
瘽	疒艹口丰
瘽	疒廿口丰
淯	氵亠厶月
宍	宀亠八
裃	衤上下
袘	衤𠂉也
嬶	女自田廾
嬾	女木口𠂊貝
嬾	女木口刀貝
絘	糸二欠
絘	糸冫欠
蓇	艹骨
茖	艹夂口
朢	臣月王
啕	口勹午凵
賍	貝广土
稃	禾爪子
籣	竹門木四
籣	竹門木日
脤	月辰
鮚	魚士口
鮐	魚厶口
鳽	一廾鳥
堽	土四一止
縠	士冖一糸殳
苳	艹夂冫
樿	木口口甲一
匰	匚口口甲一
蜊	虫禾刂
帴	巾戈戈
嵎	山日冂厶
伀	亻八厶
盦	亼㇕酉皿
凮	几一白
颸	風田心
厹	九厶
惝	心小冂口
溽	氵辰寸
涊	氵刀丶心
婥	女卜日十
珦	王宀口
輜	車巛田
碹	石宀二日
鯝	魚圍十口
綀	糸木口
縡	糸宀辛
栞	干干木
殢	一夕廿儿冖巾
拠	扌夂几
搌	扌尸廿衤
遰	之廿儿冖巾
爇	艹土儿土丸火
爇	艹土八土丸火
韁	革三田田
轔	車米夕㐄
橪	木䏑犬火
煕	臣巳火
蝳	虫丰母
蜉	虫爪子
嗩	口小貝
噍	口隹火
啍	口亠口子
髃	骨日冂厶
盉	禾皿
猁	犭禾刂
匂	勹匕
痃	疒亠幺
懆	心口口口木
惓	心半卩
渱	氵虫工
浛	氵亼㇕口
祊	示方
祤	示习习
閟	門弋八
娖	女口止
繦	糸弓口虫
坫	土卜口
珛	王𠂇月
珹	王戊㇕
揲	扌廿乚木
攠	扌广木木非
攠	扌广十儿十儿非
扠	扌又丶
茩	艹𠂆一口
茀	艹弓刂
巘	山虎一口冂八丁犬
鋩	金艹亡
錧	金宀㠯
遯	之月豕
脬	月爪子
鮂	魚圍人
廒	广士方攵
廒	广土方攵
廒	广丰力攵
怭	心弋八
皕	一白一白
垝	土𠂊厂卩
垵	土宀女
搢	扌一业日
搢	扌二厶厶日
攄	扌虎田心
拡	扌广厶
鞐	革上下
蟿	車凵殳虫
暦	厂木木日
晄	日小兀
眛	目二木
罥	四口月
罠	四巳七
嶵	山四非
啎	午二乂口
啎	午工㇕口
筰	竹亻𠂉匕
簩	竹火火冖力
僛	亻甘廾欠
俍	亻丶艮
龢	亼口口口冊禾
彴	行勹丶
舢	舟山
臓	月艹戊臣
毞	匕匕毛
豋	䏑又一口䒑
庨	广耂子
緳	广丰刀糸
羕	羊丶水
愯	心隹又
欻	火火欠
懠	心齊
悰	心宀示
溂	氵木口刂
滵	氵宀弋八山
禋	示西土
祾	示土儿夂
祾	示土八夂
冘	冖儿
冞	冖米
臦	臣臣
墬	阝彑豕土
縸	糸艹日大
鬏	長彡禾火
椇	木目廾
蠑	虫火火冖木
賕	貝十⺍丶
臢	月牛儿牛儿貝
悈	心戈廾
忭	心亠卜
瓅	王白幺幺木
藾	艹木口𠂊貝
藾	艹木口刀貝
苶	艹人小
杻	木彐丨
噭	口白方攵
唼	口立女
峠	山上下
笵	竹氵卩
偰	亻丰刀大
谻	八人口乙キ
餠	食丿干丿干
巟	亡川
凘	冫甘廾斤
麤	鹿鹿鹿
纇	米糸頁
悧	心禾刂
溘	氵土厶皿
寑	宀亻彐冖又
彠	彐工口寸艹隹又
陥	阝𠂊丨日
弶	弓亠口小
荍	艹凵攵
桫	木氵小丿
昻	日工卩
鎛	金甫寸
鈏	金弓丨
鵟	犭王鳥
廑	广艹口丰
廑	广廿口丰
垞	土宀丿七
騑	馬非
騲	馬艹日十
莁	艹工人人
醑	酉足月
彯	西示彡
霙	雨艹冂大
雰	雨八刀
跢	足夕夕
甽	田川
黢	四土火厶八夂
黢	田土火厶八夂
斁	四土半攵
盻	目八丂
睒	目火火
秪	禾氏一
秪	禾氏丶
僈	亻日四又
僈	亻冖二四又
虒	𠂆虎
膮	月土土土兀
胲	月亠凵人
觔	𠂊用力
忞	文心
謧	言亠乂凵冂厶
冱	冫一彑
怞	心由
悇	心亼木
漻	氵习习人彡
縕	糸圍人皿
妘	女二厶
婻	女十冂半
紵	糸宀丁
矻	石𠂉乙
呫	口卜口
蹁	足户冊
曀	日士冖一口䒑
籦	竹金千日土
傌	亻馬
鉏	金且
脞	月人人土
鯷	魚日一止
鰉	魚白王
庳	广鬼十
恉	心匕日
冖	冖
檗	尸口辛木
瞀	予丿攵目
絿	糸十⺍丶
隷	士示尹⺍
鵐	工人人鳥
垙	土小兀
墦	土釆田
瑧	王丰禾
鞡	革扌立
莅	艹亻立
軺	車召
郕	戊㇕阝
齕	齒𠂉乙
蟳	虫彐工口寸
嶮	山亼口口人人
徧	行户冊
瘊	疒亻コ矢
慓	心西示
溍	氵一业日
溍	氵二厶厶日
沄	氵二厶
灡	氵艹門木四
灡	氵艹門木日
渇	氵日勹匕
濧	氵业羊寸
泆	氵手丶
溞	氵又冫虫
溞	氵又丶虫
屛	尸丿干丿干
姌	女冂土
縗	糸衣口一
綅	糸彐冖又
楳	木甘木
朿	木冂
旼	日文
瞍	目臼丨又
鍉	金日一止
銛	金舌
鮠	魚𠂊厂卩
詷	言冂一口
潟	氵臼勹火
泇	氵力口
孅	女人人戈非一
瑊	王戊一口
駰	馬圍大
抃	扌亠卜
葖	艹穴犬
楅	木一口田
酺	酉甫
棶	木木人人
輠	車田木
椑	木鬼十
枠	木九十
楤	木勿丶心
黶	厂日月犬四土火
黶	厂日月犬田土火
虷	虫干
吪	口亻匕
屴	山力
簠	竹甫皿
皜	白亠口冂口
儗	亻匕矢龴足
臒	月艹隹又
猢	犭十口月
膬	月毛毛毛
瘯	疒方𠂉矢
恅	心耂匕
粋	米九十
裀	衤圍大
襜	衤𠂊厂八言
閦	門人人人
剟	又又又又刂
恝	丰刀心
蒻	艹弓冫弓冫
唪	口丰キ
踺	足廴彐キ
欥	日欠
嵁	山甘匚儿
嵁	山甘匚八
眙	目厶口
氕	气丿
譾	言䒑月刂习习
迉	之尸
絧	糸冂一口
賛	夫夫貝
頬	大䒑頁
耵	耳丁
瑒	王日一勿
藨	艹鹿火
圀	圍八方
踣	足立口
嘚	口行日一寸
黰	四土火十目廾
黰	四土火匕目廾
黰	田土火十目廾
黰	田土火匕目廾
崱	山貝刂
鼽	自田廾九
粍	米毛
瑬	氵亠厶川王丶
瀍	氵广田土八土
戽	户冫十
閖	門水
弝	弓巴
揃	扌䒑月刂
櫌	木一白冖心夂
鱺	魚一冂丶一冂丶鹿
觖	𠂊用㇕大
豇	一口䒑工
趧	走日一止
慹	土半丸心
珸	王二乂口
珸	王工㇕口
毦	耳毛
擗	扌尸口辛
蔕	艹廿儿冖巾
蔱	艹乂木殳
棫	木戈口一
轤	車虎田皿
柎	木亻寸
硏	石干干
礌	石雨田
磉	石又又又木
敺	匚口口口卜又
蹀	足廿乚木
躪	足艹門隹
晥	日宀一兀
罶	四卯田
犝	牛立田土
秖	禾氏
倴	亻大十艹
牮	亻弋牛
僗	亻火火冖力
頠	𠂊厂卩頁
焔	火𠂊丨日
熀	火日小兀
袽	衤女口
鄩	彐工口寸阝
弳	弓一巛工
嫪	女习习人彡
枒	木牙
燹	豕豕火
瘑	疒咼
焌	火厶八夂
泂	氵冂口
潚	氵尹爿一爿
奡	頁大刂
殈	一夕丿皿
琭	王彐水
攉	扌雨隹
萉	艹月巴
楱	木丰一大
檟	木西貝
輶	車八酉
啢	口一巾人人
慁	圍豕心
圐	圍四方
踽	足丿口冂厶
跘	足半
喦	口口口山
暅	日心二日
幓	巾厶厶厶人彡
瞹	目爪冖心夂
皊	白亼卩
皊	白亼龴
鐚	金亞心
鑴	金山隹冂儿口
鑴	金山隹冂八口
舡	舟工
鱲	魚巛圍乂巛
鄘	广尹用阝
洘	氵耂丂
洈	氵𠂊厂卩
襌	衤口口甲一
躄	尸口辛足
媦	女田月
婸	女日一勿
坏	土不
坶	土母
撙	扌八酉寸
艼	艹丁
蒠	艹自心
蒺	艹疒矢
栁	木夕卩
碏	石廿日
虸	虫子
躦	足牛儿牛儿貝
棐	非木
幬	巾士㇕工一口寸
够	勹口夕夕
恓	心西
汒	氵亡
袗	衤人彡
圣	又土
殙	一夕氏日
敔	二乂口攵
敔	工㇕口攵
摰	土儿土丸手
摰	土八土丸手
趯	走习习隹
擭	扌艹隹又
撚	扌䏑犬火
鄀	艹𠂇口阝
蘘	艹衣口口甘
蒟	艹立勹口
蒄	艹冖一兀寸
覅	西女勿
猋	犬犬犬
敊	上小卜又
敹	卜冖釆攵
跐	足止匕
羉	四言糸糸
崥	山鬼十
歃	千臼欠
鍈	金艹冂大
凧	几巾
颭	風卜口
膰	月釆田
鰺	魚厶厶厶人彡
烠	火𠂇月
燋	火隹火
鵷	宀夕卩鳥
娷	女千艹二
繺	幺𠂊彐攵火
繶	糸立日心
墚	土氵刀八木
琁	王𠂉足
晛	日見
帡	巾䒑廾
筲	竹小月
餤	食火火
訬	言小丿
瘖	疒立日
陊	阝夕夕
頇	干頁
鬺	一口冂八丁𠂉日一勿
璈	王士方攵
璈	王土方攵
璈	王丰力攵
璆	王习习人彡
莿	艹木冂刂
蒤	艹氵亼木
醐	酉十口月
蜍	虫亼木
啀	口厂土土
餥	非食
暎	日艹冂大
畯	田厶八夂
幏	巾宀豕
皦	白白方攵
僇	亻习习人彡
瓟	瓜勹巳
褩	舟殳衣
鯸	魚亻コ矢
爣	火小冖口四土火
爣	火小冖口田土火
潩	氵田艹廾
襴	衤門木四
襴	衤門木日
褌	衤冖車
塈	艮旡土
纆	糸四土火土
纆	糸田土火土
縦	糸行䒑止
垪	土䒑廾
蓱	艹氵䒑廾
遝	之四水
眴	目勹日
筭	竹王廾
稂	禾丶艮
鮦	魚冂一口
謚	言䒑八皿
殍	一夕爪子
墈	土甘匚儿力
墈	土甘匚八力
堌	土圍十口
垀	土爪丁
玊	王丶
顢	廿巾人人頁
韂	革𠂊厂八言
芿	艹亻㇕丿
喒	口夂卜日
噰	口亠乚凵隹
噂	口八酉寸
曵	申丿丶
晙	日厶八夂
巂	山隹冂儿口
巂	山隹冂八口
箢	竹宀夕卩
鼢	臼釆八刀
俛	亻召儿
餖	食一口䒑
鋀	金一口䒑
鋐	金宀𠂇厶
憓	心一日厶心
憺	心𠂊厂八言
綷	糸亠人人十
紞	糸冖儿
擿	扌之亠八冂十口
韮	艹非一
蕣	艹爪冖夕㐄
朸	木力
蹯	足釆田
仭	亻刀丶
鏾	金廿月攵
臗	月宀艹見丶
痏	疒𠂇月
誾	門言
蝥	予丿攵虫
貮	戈貝
摋	扌乂木殳
葍	艹一口田
遖	之十冂半
靬	革干
蕡	艹十艹貝
蒡	艹亠八冖方
蕷	艹予頁
輇	車人王
剗	戈戈刂
掔	臣又手
蚿	虫亠幺
咮	口𠂉木
鶡	日勹亡鳥
秏	禾毛
毪	毛厶牛
傉	亻辰寸
儽	亻田田田糸
皐	白⺍十
僋	亻亼㇕貝
鉐	金石
鉱	金广厶
猄	犭亠口小
鱓	魚口口甲一
鰯	魚弓冫弓冫
鷟	方𠂉矢鳥
癙	疒臼釆
怳	心口儿
燂	火西日十
洓	氵木冂
淛	氵牛巾刂
渓	氵爪夫
褖	衤彑豕
冦	冖一兀卜又
巹	㇕水一巳
阨	阝厂卩
纚	糸一冂丶一冂丶鹿
碃	石丰月
磲	石氵匚コ木
蹖	足丰臼
唶	口廿日
呾	口日一
踟	足矢口
岍	山一廾
劁	隹火刂
銤	金米
猰	犭丰刀大
訌	言工
濩	氵艹隹又
塨	土艹廾心
靸	革𠂊又
菳	艹金
薿	艹匕矢龴足
槄	木爪臼
鄠	雨一丂阝
鄠	雨丂一阝
蟥	虫廿由八
晻	日大申
睆	目宀一兀
穊	禾艮旡
鞗	亻丨夂革
鞗	亻丨攵革
侅	亻亠凵人
貑	豸尸二コ又
艅	舟亼木
憝	亠口子攵心
譹	言亠口冖豕
羮	羊火丰
鄫	八四日阝
鄫	八田日阝
懽	心艹口口隹
糨	米弓口虫
糨	米弓厶虫
燏	火予丿冂儿口
燏	火予丿冂八口
袨	衤亠幺
毣	习习毛
嫽	女一火日小
抮	扌人彡
嚆	口艹亠口冂口
眊	目毛
眕	目人彡
眵	目夕夕
瞷	目門日
箖	竹木木
釿	金斤
鱝	魚十艹貝
皸	冖車皮
嫻	女門木
瓨	工瓦
騍	馬田木
揠	扌匚日女
鶾	十日十𠂉鳥
菧	艹广氏一
菧	艹广氏丶
轕	車艹日勹亡
樛	木习习人彡
犮	犬丿
犮	犬㇕
甗	虎一口冂八丁瓦
蟜	虫丿大口冂口
蟓	虫召豕
嗢	口日皿
昣	日人彡
嫳	巾⺍攵女
嶪	山业半木
箶	竹十口月
箙	竹月卩又
仱	亻亼㇕
狳	犭亼木
猟	犭⺍几キ
狖	犭穴
嚲	亠口子口口甲一
諝	言足月
廙	广田艹廾
潽	氵立立日
寖	宀氵彐冖又
縩	糸䏑又示
墺	土宀米大
扐	扌力
栘	木夕夕
圁	圍言
曨	日龍
鼷	臼釆爪幺大
眢	夕卩目
諆	言甘廾
絰	糸至
剅	一口䒑刂
藟	艹田田田
薡	艹目爿爿
輐	車宀一兀
迍	之丿屮
迍	之一屮
岞	山𠂉匕
熈	丿臣巳火
牓	爿亠八冖方
郈	𠂆一口阝
錼	金大示
脁	月儿⺍
敻	𠂊冂人目攵
欬	亠凵人欠
潅	氵𠂉一隹
洨	氵亠八乂
寃	宀召儿丶
頞	宀女頁
窊	穴瓜
臩	臣臣大刂
焄	尹口火
茻	屮屮屮屮
摂	扌耳⺍
枻	木廿乚
晅	日二日
侁	亻牛儿
銍	金至
猞	犭亼十口
讌	言廿口北火
汋	氵勹丶
艴	弓刂𠂊巴
妬	女石
嚢	一中冖八甘衤
遶	之土土土兀
斲	卯亞斤
髫	長彡召
蓰	艹行止止
桲	木十冖子
椆	木用口
羍	大羊
厗	厂辛
勔	頁圍力
蝻	虫十冂半
喍	口止匕木
嶲	山隹冂凵
敳	山一口䒑攵
嶰	山𠂊用刀牛
瞵	目米夕㐄
矊	目糸白巾
牥	牛方
嶨	臼乂乂冖山
擧	臼一乚丨廾手
僽	亻禾火心
侂	亻广丿七
魵	魚八刀
邅	之亠圍口日一
醤	爿爪寸酉
慠	心士方攵
慠	心土方攵
慠	心丰力攵
煓	火山而
熥	火之龴用
沷	氵犬丿
沷	氵犬㇕
沘	氵匕匕
瀯	氵火火冖口口
瀯	氵火火冖口丿口
疎	足木口
妠	女冂人
妭	女犬丿
妭	女犬㇕
緵	糸乂凵八夂
霅	雨言
昫	日勹口
嶔	山金欠
僩	亻門月
鍠	金白王
猦	犭風
縢	月半糸
膣	月穴至
諲	言西土
淜	氵月月
墝	土土土土兀
覩	耂見
璪	王口口口木
莵	艹召儿丶
蔤	艹宀弋八山
榼	木土厶皿
醾	酉广木木米
醾	酉广十儿十儿米
椌	木穴工
牻	牛尤彡
酇	牛儿牛儿貝阝
穭	禾魚日
侹	亻廴工一
侹	亻廴丿士
侹	亻廴亻土
倧	亻宀示
粔	米匚コ
炟	火日一
焠	火亠人人十
沇	氵厶儿
窋	穴屮凵
孲	子亞
暋	巳七攵日
姱	女大一丂
姱	女大丂一
綼	糸鬼十
荸	艹十冖子
萯	艹𠂊貝
桯	木口王
桯	木口亻土
筬	竹戊㇕
泝	氵斤丶
塅	土厂三殳
埶	土儿土丸
埶	土八土丸
盩	土半攵皿
玶	王干八
駔	馬且
驌	馬尹爿一爿
掫	扌耳又
硜	石一巛工
螵	虫西示
蠋	虫四勹虫
圌	圍山而
塁	田⺍土
罫	四土土卜
罝	四且
骹	骨亠八乂
簳	竹十日十人干
筦	竹宀一兀
倢	亻一彐止
偨	亻止匕木
儹	亻牛儿牛儿貝
俤	亻弋弓
腷	月一口田
狛	犭白
肸	月八十
顚	匕目廾頁
廌	鹿一乚火
瘝	疒四水
澣	氵十日十人干
漎	氵行人人止
賨	宀示貝
岊	巴山
媥	女户冊
趑	走二欠
趑	走冫欠
鞬	革廴彐キ
蝀	虫木日
嚥	口廿口北火
嚫	口立木見
贐	貝尹一火皿
傃	亻丰糸
偞	亻廿乚木
歛	亼口口人人欠
鈃	金一廾
鏷	金业半大
鈩	金户
谿	爪幺大八人口
讘	言耳耳耳
頏	亠几頁
塭	土日皿
埇	土龴用
耟	耒匚コ
掞	扌火火
鞁	革皮
茝	艹臣
苅	艹乂刂
輣	車月月
衊	丿皿艹四戈人
筊	竹亠八乂
偩	亻𠂊貝
侭	亻尸丶冫
獏	犭艹日大
狴	犭匕匕土
鄮	卯貝阝
鱠	魚亼四日
廯	广魚羊
溚	氵艹亼口
鵼	穴工鳥
祂	示也
粛	尹川米
屓	尸貝
翭	习习亻コ矢
娀	女戈𠂇
綖	糸廴丿止
玭	王匕匕
晊	日至
盳	目亡
簻	竹之咼
簜	竹氵日一勿
儜	亻宀心皿丁
鏻	金米夕㐄
漶	氵中中心
垾	土日干
墽	土白方攵
塡	土匕目廾
駺	馬丶艮
摐	扌行人人止
撖	扌丁耳攵
撖	扌㇕耳攵
劐	艹隹又刂
櫙	木艹匚口口口
輖	車用口
孁	雨口口口女
齵	齒日冂厶
蝤	虫八酉
蚆	虫巴
蹍	足尸廿衤
躐	足巛圍乂巛
跼	足尸㇕口
囅	口口甲一尸廿衤
唅	口亼㇕口
畳	田冖且
秬	禾匚コ
秡	禾犬丿
秡	禾犬㇕
錞	金亠口子
钃	金尸水四勹虫
獪	犭亼四日
腃	月半卩
龒	龍示
糈	米足月
惉	氵卜口心
澴	氵四一口衤
禖	示甘木
賮	尹一火貝
繊	糸十戈业
莇	艹且力
礓	石三田田
迵	之冂一口
輋	山大車
筢	竹扌巴
犄	牛大丁口
嬃	彡頁女
惏	心木木
潾	氵米夕㐄
阢	阝兀
耥	耒小冂口
駉	馬冂口
萳	艹十冂半
鄚	艹日大阝
蒈	艹匕匕白
蕫	艹立田土
榲	木圍人皿
嚠	口卯金刂
暕	日木四
暕	日木日
巓	山匕目廾頁
睎	目乂𠂇巾
眹	目䒑大
勧	𠂉一隹力
箟	竹日匕匕
鋙	金二乂口
鋙	金工㇕口
鶵	勹屮勹屮鳥
遆	之亠八冖巾
潬	氵口口甲一
鍌	氵牛儿金
窉	穴一冂人
姡	女舌
菺	艹户月
轘	車四一口衤
栟	木䒑廾
咇	口弋八
蹜	足宀亻一白
爞	火虫虫虫
陑	阝而
媱	女爪午凵
媱	女䏑午凵
繝	糸門月
殗	一夕大申
郚	二乂口阝
郚	工㇕口阝
朅	土厶日勹亡
鬪	鬥一口䒑寸
駏	馬匚コ
騋	馬木人人
騂	馬辛
珝	王习习
斠	甘冂土冫十
酄	艹口口隹阝
蘂	艹心心心木
蔃	艹弓口虫
蔃	艹弓厶虫
椪	木立立
厤	厂禾禾
蟌	虫囟夂心
蟌	虫囟丿乂心
螗	虫广尹口
幰	巾宀丰四心
犓	牛勹屮勹屮
讐	隹隹言
倅	亻亠人人十
徯	行爪幺大
頴	匕示頁
瘜	疒自心
憕	心癶一口䒑
濔	氵一八巾乂乂乂乂
潎	氵巾氵攵
濶	氵門舌
祣	示𠂉亻
褵	衤亠乂凵冂厶
鸊	尸口辛鳥
覗	㇕一口見
彉	弓廿由八
芔	屮屮屮
紩	糸手丶
妎	女亻八
偡	亻甘匚儿
偡	亻甘匚八
錍	金鬼十
鱕	魚釆田
耖	耒小丿
騛	馬乙冫丿刂乙冫
輂	艹廾車
輈	車舟
棪	木火火
雿	雨儿⺍
蝓	虫亼月刂
蝓	虫亼月巛
呍	口二厶
踡	足半卩
甞	小冖口甘
晬	日亠人人十
罛	四瓜
岋	山𠂊又
犋	牛目廾
鼱	臼釆丰月
儃	亻亠圍口日一
偐	亻立丿彡
餀	食艹乂
鷉	𠂆虎鳥
鑞	金巛圍乂巛
麑	鹿臼儿
怮	心幺力
窾	穴士示欠
襐	衤召豕
裞	衤八口儿
裲	衤一巾人人
袧	衤勹口
糺	糸乚
薖	艹之咼
蔊	艹火日干
襾	一冂凵
枓	木冫十
砏	石八刀
蜎	虫口月
曊	日弓刂貝
倛	亻甘廾
腜	月甘木
脎	月乂木
雘	冊丶艹隹又
惵	心廿乚木
愐	心頁圍
泃	氵勹口
阽	阝卜口
緺	糸咼
絣	糸䒑廾
坲	土弓刂
瓛	王虎一口冂八丁犬
驓	馬八四日
驓	馬八田日
騄	馬彐水
搋	扌𠂆虎
靰	革兀
剳	艹亼口刂
蔉	艹衣八口
醁	酉彐水
梣	木山亼㇕
榶	木广尹口
螘	虫山一口䒑
蠵	虫山隹冂儿口
蠵	虫山隹冂八口
吰	口𠂇厶
蹡	足爿䏑寸
噛	口齒
勗	日且力
鷃	日宀女鳥
幠	巾𠂉廿廿火
黲	四土火厶厶厶人彡
黲	田土火厶厶厶人彡
罜	四丶王
巌	山⺍厂丁耳攵
巌	山⺍厂㇕耳攵
崒	山亠人人十
峛	山一夕刂
牦	牛毛
稊	禾弋弓
伷	亻由
僔	亻八酉寸
錺	金艹方
飂	風习习人彡
獥	犭白方攵
狔	犭尸匕
腍	月亼㇕心
朏	月屮凵
謣	言雨一丂
謣	言雨丂一
謢	言隹又
謵	言习习白
庌	广牙
麀	鹿匕
灊	氵旡旡一口冂八丁
滭	氵甲艹二
湩	氵千日土
溓	氵禾禾彐
潏	氵予丿冂儿口
潏	氵予丿冂八口
祴	示戈廾
闉	門西土
頵	尹口頁
阬	阝亠几
丱	凵凵
緌	糸禾女
綯	糸勹午凵
蓷	艹扌隹
杕	木大
佖	亻弋八
迻	之夕夕
訧	言尤
桊	半木
怐	心勹口
沺	氵田
墣	土业半大
瑳	王羊工
騵	馬厂白小
揜	扌亼口廾
薗	艹圍土口衤
蒩	艹禾且
棽	木木亼㇕
槪	木白匕旡
盬	臣丿舌皿
蝜	虫𠂊貝
圂	圍豕
牚	小冖口牙
矰	矢八四日
矰	矢八田日
牬	牛丿乚亻
牿	牛牛口
篸	竹厶厶厶人彡
犨	隹隹牛
餻	食羊火
鑚	金夫夫貝
鈚	金匕匕
鑱	金召匕匕召儿丶
犰	犭九
猭	犭彑豕
鵩	月卩又鳥
廞	广金欠
羖	羊殳
熇	火亠口冂口
瀿	氵𠂉母攵糸
覜	儿⺍見
澦	氵予頁
湑	氵足月
祲	示彐冖又
褞	衤日皿
繑	糸丿大口冂口
婌	女上小又
坰	土冂口
琄	王口月
珖	王小兀
踇	足𠂉母
咍	口厶口
笭	竹亼卩
笭	竹亼龴
鉧	金母
觫	𠂊用木口
鮥	魚夂口
緖	糸耂丶
塙	土亠口冂口
毊	士尸殳丿大口冂口
蔎	艹言殳
莐	艹氵冖儿
荵	艹刀丶心
醽	酉雨口口口
蚖	虫一兀
鸆	虎口一大鳥
鸆	虎口乚大鳥
鸆	虎口乚廾鳥
嘒	口丰丰彐
碞	口口口石
昄	日厂又
昄	日𠂆又
黮	四土火甘匚儿
黮	四土火甘匚八
黮	田土火甘匚儿
黮	田土火甘匚八
睾	丿四土半
郳	臼儿阝
倕	亻千艹二
狟	犭二日
猵	犭户冊
頄	九頁
鱚	魚士口䒑口
讙	言艹口口隹
瘈	疒丰刀大
庛	广止匕
鷁	䒑八皿鳥
惙	心又又又又
愶	心力力力月
漑	氵白匕旡
澼	氵尸口辛
盝	彐水皿
緤	糸廿乚木
邘	丁一阝
朹	木九
蚚	虫斤
饐	食士冖一口䒑
涒	氵尹口
慭	木䒑犬心
琈	王爪子
珓	王亠八乂
驎	馬米夕㐄
挍	扌亠八乂
鞄	革勹巳
蔝	艹目米
柂	木𠂉也
豲	豕厂白小
豗	兀豕
皻	虎且皮
嚬	口止癶頁
暩	日䏑又示
崌	山尸十口
巇	山虎一口䒑戈
箑	竹一彐止
筯	竹且力
傎	亻十目廾
傎	亻匕目廾
攽	八刀攵
鯑	魚乂𠂇巾
鳦	鳥乙
瘲	疒行人人止
羱	羊厂白小
渮	氵艹丁口
漼	氵山隹
浟	氵亻丨夂
浟	氵亻丨攵
袚	衤犬丿
袚	衤犬㇕
姈	女亼卩
姈	女亼龴
枲	厶口木
坬	土瓜
珌	王弋八
顠	西示頁
梛	木刀二阝
筥	竹口口
筥	竹口丿口
俴	亻戈戈
僿	亻宀甘八土
鯫	魚耳又
迖	之犬
氂	二木攵厂毛
挀	扌𠂆亻
捖	扌宀一兀
蒚	艹一口冂八丁
藂	艹耳又亻
轀	車圍人皿
梲	木八口儿
枌	木八刀
霢	雨月𠂆亻
攲	大丁口十又
耎	而大
黺	业巾⺍八刀
牷	牛人王
臿	千臼
秺	禾宀丿七
筳	竹廴工一
筳	竹廴丿士
筳	竹廴亻土
毹	亼月刂毛
毹	亼月巛毛
鞶	舟殳革
猧	犭咼
毚	召匕匕召儿丶
旍	方𠂉亼卩
旍	方𠂉亼龴
泭	氵亻寸
惌	宀夕卩心
禡	示馬
韔	㐄口㐄長
檃	阝爪工彐木
姧	女女干
媓	女白王
緂	糸火火
杅	木丁一
醱	酉癶弓殳
礞	石艹冖一豕
厞	厂非
螝	虫鬼
蜣	虫羊儿
筈	竹舌
鮨	魚匕日
諌	言木日
愲	心骨
怊	心召
紃	糸川
鬐	長彡耂匕日
髧	長彡冖儿
菶	艹丰キ
惎	甘廾心
酨	十戈酉
杬	木一兀
醨	酉亠乂凵冂厶
楪	木廿乚木
尞	一火日小
蠀	虫二欠貝
蠀	虫冫欠貝
昡	日亠幺
帨	巾八口儿
髄	骨之𠂇月
箊	竹方人冫
臈	月艹日勹亡
夆	夂丰
鄗	亠口冂口阝
瓬	方瓦
犘	广木木牛
犘	广十儿十儿牛
癐	疒亼四日
憟	心西米
忳	心丿屮
忳	心一屮
熜	火囟夂心
熜	火囟丿乂心
湋	氵㐄口㐄
窫	穴丰刀大
禷	示米犬頁
襶	衤十戈田艹廾
襡	衤四勹虫
閊	門山
婍	女大丁口
挐	女口手
媖	女艹冂大
綛	糸刀丶心
鄕	乚凵白匕阝
殭	一夕三田田
拑	扌甘
揝	扌夂卜日
掻	扌又虫
萺	艹日目
萺	艹冖二目
蘹	艹心衣四水
檽	木雨而
矼	石工
砫	石丶王
簙	竹十甫寸
諀	言鬼十
剫	广廿又刂
垺	土爪子
蠧	士冖石虫虫
玼	王止匕
糵	艹丿㠯辛米
醸	酉衣八甘
歅	西土欠
柅	木尸匕
觱	戊一口𠂊用
疁	田习习人彡
虩	小日小虎
幙	巾艹日大
嵃	山立丿彡
嶓	山釆田
巃	山龍
犂	禾丿刀牛
魋	鬼隹
鐶	金四一口衤
鋋	金廴丿止
艒	舟日目
艒	舟冖二目
臞	月目目隹
獟	犭土土土兀
鸑	犭言犬鳥
鰮	魚圍人皿
鮗	魚夂冫
鮡	魚儿⺍
懪	心日艹廾水
烱	火冂儿口
烱	火冂八口
慆	心爪臼
浤	氵宀𠂇厶
寪	宀爲
繀	糸山隹
嫭	女虎爪丁
梠	木口口
梠	木口丿口
橚	木尹爿一爿
犪	牛八頁止巳夂
閷	乂木門人
鐕	金旡旡日
鐋	金氵日一勿
夘	夕卩
誷	言冂䒑亡
瑑	王彑豕
搒	扌亠八冖方
葝	艹一巛工力
薋	艹二欠貝
薋	艹冫欠貝
酏	酉也
楉	木艹𠂇口
繄	匚矢殳糸
齛	齒廿乚
噀	口巳巳艹廾
氀	婁毛
氍	目目隹毛
眽	目𠂆亻
睠	目半卩
箒	竹彐冖巾
忥	气心
侴	亼彐丨刂
獦	犭艹日勹亡
鯥	魚土儿土
鯥	魚土八土
觿	𠂊用山隹冂儿口
觿	𠂊用山隹冂八口
浢	氵一口䒑
淔	氵十目
潐	氵隹火
禨	示幺幺戈人
閇	門下
阹	阝土厶
繵	糸亠圍口日一
抆	扌文
芅	艹弋
廼	廴西
檛	木之咼
篛	竹弓冫弓冫
僆	亻之車
伬	亻尸丶
餕	食厶八夂
錏	金亞
媬	女亻口木
殣	一夕艹口丰
殣	一夕廿口丰
塥	土一口冂八丁
褧	耳火衣
髣	長彡方
聱	士方攵耳
聱	土方攵耳
聱	丰力攵耳
珶	王弋弓
攦	扌一冂丶一冂丶鹿
挓	扌宀丿七
捥	扌宀夕卩
尭	十艹兀
藙	艹立豕殳
蓪	艹之龴用
楬	木日勹亡
檓	木臼工殳
砯	石水丶
祡	止匕示
蝪	虫日一勿
甿	田亡
旿	日午
帾	巾耂
箷	竹方𠂉也
烋	亻木火
餂	食舌
钂	金小冖口四土火
钂	金小冖口田土火
獳	犭雨而
朘	月厶八夂
鱣	魚亠圍口日一
匊	勹米
廗	广廿儿冖巾
忣	心𠂊又
韣	㐄口㐄四勹虫
癹	癶殳
姎	女冂大
絻	糸召儿
纕	糸衣口口甘
笴	竹丁口
鋳	金丰寸
膍	月囟匕匕
糌	米夂卜日
縎	糸骨
塿	土婁
耠	耒亼口
璮	王亠圍口日一
驦	馬雨木目
抾	扌土厶
搷	扌十目廾
搷	扌匕目廾
擫	扌厂日月犬
搨	扌日习习
摡	扌艮旡
靾	革廿乚
蓳	艹艹口丰
蓳	艹廿口丰
蟼	艹勹口攵虫
棯	木亼㇕心
敧	大丁口卜又
匽	匚日女
匢	匚勿
嚚	口口臣口口
崝	山丰月
崀	山丶艮
簉	竹之牛口
篽	竹行午止卩
儌	亻白方攵
儦	亻鹿火
鄬	爲阝
狣	犭儿⺍
胕	月亻寸
腯	月𠂆十目
腟	月宀至
雊	勹口隹
廇	广卯田
熅	火圍人皿
褮	火火冖衣
漙	氵一日厶寸
渻	氵小丿目
漴	氵山宀示
裄	衤行
裗	衤亠厶川
鶤	冖車鳥
韎	㐄口㐄一木
弽	弓廿乚木
嫇	女冖日亠八
繣	糸彐キ田一
弃	亠厶廾
蒱	艹扌甫
菼	艹火火
穄	禾䏑又示
鑛	金广廿由八
鰒	魚𠂉日夂
涽	氵氏日
犎	土土寸牛
壝	土之中一貝
壌	土衣八甘
摴	扌雨一丂
摴	扌雨丂一
抇	扌日
萐	艹一彐止
靻	革且
栵	木一夕刂
尃	甫寸
櫑	木田田田
楡	木亼月巛
霫	雨习习白
蝃	虫又又又又
羂	四糸口月
嵕	山乂凵八夂
岧	山召
蠈	貝戈𠂇虫
賵	貝日目
賵	貝冖二目
箘	竹圍禾
籔	竹婁攵
兪	亼月巛
飣	食丁
瓥	瓜豕虫虫
舠	舟刀
颲	風一夕刂
猺	犭爪午凵
猺	犭䏑午凵
鮄	魚弓刂
褭	衣馬
鸇	亠圍口日一鳥
惤	心弓亠幺
裯	衤用口
邲	弋八阝
繠	心心心糸
敯	巳七日卜又
剼	厶厶厶人彡刂
极	木𠂊又
茠	艹亻木
蔍	艹鹿
杙	木弋
柤	木且
靃	雨隹隹
儤	亻日艹廾水
佁	亻厶口
鐇	金釆田
鋲	金斤廾
狺	犭言
詧	䏑又言
讋	龍言
瘃	疒豕
沶	氵示
殏	一夕十⺍丶
刲	土土刂
堉	土亠厶月
垿	土广予
棸	耳又木
莍	艹十⺍丶
蕸	艹之尸二コ又
芧	艹予
榃	木木田
槬	木大一丂瓜
槬	木大丂一瓜
檇	木隹冂凵
麭	木人人夂勹巳
楟	木亠口冖丁
槮	木厶厶厶人彡
鷖	匚矢殳鳥
螬	虫一曲日
峘	山二日
矱	矢艹隹又
玁	犭口口厂丁耳攵
玁	犭口口厂㇕耳攵
狪	犭冂一口
鯯	魚牛巾刂
羗	羊儿厶
緛	糸而大
媂	女亠八冖巾
砮	女又石
茋	艹氏一
茋	艹氏丶
篴	竹之豕
鉋	金勹巳
胑	月口八
腇	月禾女
訄	九言
迆	之也
刓	一兀刂
捗	扌止癶
扢	扌𠂉乙
擸	扌巛圍乂巛
茿	艹工凡
雚	艹口口隹
芺	艹丿大
蓹	艹行午止卩
橁	木竹勹日
磑	石山一口䒑
硿	石穴工
蟫	虫西日十
螠	虫䒑八皿
跅	足斤丶
蹛	足廿儿冖巾
咢	口口一丂
咢	口口丂一
噣	口四勹虫
罞	四予丿
崿	山口口一丂
崿	山口口丂一
睩	目彐水
筻	竹一日乂
稙	禾十目
筩	竹龴用
魆	鬼戈乚
侫	亻亡女
伔	亻冖几
僝	亻尸子子子
儠	亻巛圍乂巛
胠	月土厶
臛	月雨隹
猀	犭氵小丿
鰅	魚日冂厶
讟	言士四貝言
譓	言一日厶心
裛	衣口巴
庈	广亼㇕
癓	疒行山一几攵
煆	火尸二コ又
慴	心习习白
璗	氵日一勿王丶
屧	尸行廿乚木
緀	糸一尹女
娵	女耳又
媟	女廿乚木
繜	糸八酉寸
珇	王且
磞	石山月月
戉	戈乚
鱆	魚立日十
迿	之勹日
縺	糸之車
墕	土一止一乚火
璱	王王王弋八
耰	耒一白冖心夂
顜	甘冂土頁
葹	艹方𠂉也
檮	木士㇕工一口寸
楒	木田心
椸	木方𠂉也
櫠	木广癶弓殳
耏	而彡
逴	之卜日十
惄	上小又心
蛜	虫亻尹
喩	口亼月巛
矙	目門丁耳攵
矙	目門㇕耳攵
牣	牛刀丶
倰	亻土儿夂
倰	亻土八夂
鯈	亻丨夂魚
鯈	亻丨攵魚
皀	白匕
饛	食艹冖一豕
鎡	金䒑幺幺
狶	犭乂𠂇巾
胐	月屮凵
鱨	魚小冖口匕日
麕	鹿圍禾
慒	心一曲日
墯	心𠂇工月土
嫈	火火冖女
瀀	氵一白冖心夂
滮	氵虎彡
澨	氵竹工人人
宨	宀儿⺍
歠	又又又又酉欠
櫆	木鬼冫十
柀	木皮
蹐	足⺍人月
詗	言冂口
疢	疒火
耇	耂勹口
騤	馬癶一大
捄	扌十⺍丶
莟	艹亼㇕口
杤	木一力
槱	木酉火
榤	木夕㐄木
豭	豕尸二コ又
蠙	虫宀一癶貝
嵜	山亠八丁口
睟	目亠人人十
髇	骨亠口冂口
鵞	手戈鳥
儓	亻士口冖至
臮	自亻
斶	斤四勹虫
鈒	金𠂊又
鉾	金厶牛
獫	犭亼口口人人
胣	月𠂉也
朣	月立田土
鯣	魚日勿
鵻	鳥隹
襃	衣臼口木
竸	立日儿立日儿
旐	方𠂉儿⺍
憯	心旡旡日
愓	心日一勿
憿	心白方攵
窐	穴土土
禫	示西日十
闠	門中一貝
劙	彑豕虫虫刂
杄	木千
碪	石甘匚儿
碪	石甘匚八
磥	石田糸
籛	竹金戈戈
鶖	禾火鳥
偖	亻耂
鉼	金䒑廾
詖	言皮
痓	疒至
疕	疒匕
擏	扌艹勹口攵
拵	扌一亻子
葱	艹勿丶心
礑	石小冖口田
磏	石禾禾彐
虤	虎虎
虡	虎业八
勴	虎田心力
蟐	虫小冖口巾
嗊	口工貝
咈	口弓刂
暿	日士口䒑口
盷	目勹冫
盷	目勹二
犅	牛冂䒑山
犏	牛户冊
嵆	禾尤山
谺	八人口牙
鑯	金人人戈非一
魶	魚冂人
鰡	魚卯田
甮	勿用
褢	衣鬼
炣	火丁口
熛	火西示
焞	火亠口子
澒	氵工頁
潖	氵王王巴
浰	氵禾刂
瀺	氵召匕匕召儿丶
闤	門四一口衤
翆	习习九十
緁	糸一彐止
嫕	女匚矢心
莤	艹酉
礉	石白方攵
虰	虫丁
旴	日丁一
鐻	金虎豕
狦	犭冂刂二
蠪	龍虫
洴	氵䒑廾
肂	一夕彐キ
疌	一彐止
瑔	王白水
騊	馬勹午凵
颿	馬風
冓	甘冂土
荂	艹大一丂
荂	艹大丂一
薁	艹宀米大
酖	酉冖儿
輴	車𠂆十目
靆	雨二厶之尹⺍
踼	足日一勿
緜	白巾丿糸
谼	八人口艹廾
鶹	卯田鳥
玈	亠幺𠂉亻
爁	火臣𠂉丶皿
爁	火臣𠂉一皿
溹	氵十冖糸
滖	氵衣口一
漒	氵弓口虫
漒	氵弓厶虫
犚	尸示寸牛
翴	习习之車
姶	女亼口
絫	厶厶厶糸
斮	廿日斤
蓏	艹瓜瓜
郙	甫阝
桭	木辰
椓	木豕
柶	木四
砠	石且
蚳	虫氏一
蚳	虫氏丶
咺	口二日
羇	四革大丁口
睄	目小月
垈	亻弋土
弅	八刀廾
旟	方𠂉臼一乚丨廾
絓	糸土土
郖	一口䒑阝
墡	土羊䒑口
垏	土彐キ
鬒	長彡十目廾
鬒	長彡匕目廾
駣	馬儿⺍
鼒	十丿目爿爿
萷	艹小月刂
柾	木一止
覊	西革馬
揅	石一廾手
鹸	卜圍乂亼口人
胔	止匕䏑
蚗	虫㇕大
踘	足勹米
嗈	口巛口巴
黚	四土火甘
黚	田土火甘
崏	山氏日
穣	禾衣八甘
傱	亻行人人止
膃	月圍人皿
腨	月山而
獞	犭立田土
愊	心一口田
憭	心一火日小
滍	氵屮一虫
禓	示日一勿
雝	巛口巴隹
繷	糸曲辰
塤	土口貝
玔	王川
璲	王之八豕
瑂	王尸目
搰	扌骨
扡	扌也
垔	西土
虖	虎爪丁
睧	目氏日
鉥	金木丶
鉥	金十儿丶
怗	心卜口
恀	心夕夕
浿	氵貝
垽	氵斤土
泒	氵瓜
戤	㇕丿又皿戈
絽	糸口口
絽	糸口丿口
瓩	瓦千
埻	土亠口子
埪	土穴工
騨	馬⺍甲一
尠	甘匚儿小丿
尠	甘匚八小丿
藰	艹卯金刂
轓	車釆田
樆	木亠乂凵冂厶
硴	石艹亻匕
敁	卜口卜又
蚑	虫十又
齗	齒斤
鷶	四貝鳥
籖	竹十戈非一
篊	竹氵艹廾
鰊	魚木四
鰊	魚木日
褱	衣四水
麌	鹿口一大
麌	鹿口乚大
麌	鹿口乚廾
籺	米𠂉乙
浺	氵心中
鴳	宀女鳥
鷫	尹爿一爿鳥
脀	㇕水一月
絁	糸𠂉也
縿	糸厶厶厶人彡
玒	王工
揤	扌艮卩
橿	木三田田
榠	木冖日亠八
箎	竹虎
腤	月立日
蜰	月巴虫
渽	氵十戈口
丏	丁乚㇕
嫢	夫見女
壖	土雨而
髢	長彡也
珋	王卯
摵	扌戊上小
搉	扌冖隹
鞙	革口月
橞	木一日厶心
輌	車一冂山
棆	木亼冊
郲	木人人阝
椨	木广亻寸
霒	雨二厶亼㇕
椵	木尸二コ又
蟅	虫广廿火
踦	足大丁口
喿	口口口木
帊	巾巴
黓	四土火弋
黓	田土火弋
岨	山且
峿	山二乂口
峿	山工㇕口
鵙	貝鳥
犆	牛十目
笯	竹女又
儳	亻召匕匕召儿丶
傔	亻禾禾彐
僪	亻予丿冂儿口
僪	亻予丿冂八口
嵞	亼木山山
劔	亼口口人人刀丶
爼	乂乂且
饂	食日皿
狤	犭士口
魣	魚予
穈	广木木禾
穈	广十儿十儿禾
罃	火火冖午凵
憸	心亼口口人人
愼	心匕目廾
懰	心卯金刂
漧	氵十日十𠂉乙
淴	氵勿心
礿	示勹丶
鼆	冖日亠八黽
瑃	王丰日
桟	木二戈
杣	木山
瞶	目中一貝
衖	行艹廾
鋗	金口月
腞	月彑豕
訒	言刀丶
泬	氵穴
坉	土丿屮
坉	土一屮
挴	扌𠂉母
茢	艹一夕刂
靮	革勹丶
靿	革幺力
茘	艹刀刀刀
醲	酉曲辰
硠	石丶艮
逌	之卜圍コ
蝋	虫⺍几キ
啅	口卜日十
踧	足上小又
囋	口牛儿牛儿貝
晼	日宀夕卩
笝	竹圍又
衃	丿皿不
毇	臼米殳
儑	亻日幺幺火
鶬	人户口鳥
鎞	金囟匕匕
艎	舟白王
旓	方𠂉小月
楶	二欠口木
楶	冫欠口木
憀	心习习人彡
汫	氵二刂
泲	氵丿乚亻
瀌	氵鹿火
韘	㐄口㐄廿乚木
鳲	尸鳥
翣	习习立女
婐	女田木
坴	土儿土
坴	土八土
掯	扌止月
蕼	艹長彐キ
苙	艹立
榾	木骨
柲	木弋八
梫	木彐冖又
咶	口舌
馝	禾日弋八
筶	竹牛口
侲	亻辰
僶	亻黽
悁	心口月
夒	頁止巳夂
堐	土厂土土
栔	丰刀木
揊	扌一口田
薣	艹士口䒑十又
醧	酉匚口口口
轒	車十艹貝
輁	車艹廾
軦	車口儿
憖	木人人犬心
礵	石雨木目
硊	石𠂊厂卩
磳	石八四日
磳	石八田日
畷	田又又又又
罳	四田心
黵	四土火𠂊厂八言
黵	田土火𠂊厂八言
簁	竹行止止
侐	亻丿皿
豃	八人口丁耳攵
豃	八人口㇕耳攵
癋	疒亞心
麃	鹿火
粻	米長
粃	米匕匕
燀	火口口甲一
悀	心龴用
汯	氵𠂇厶
悹	宀㠯心
窴	穴十目廾
窴	穴匕目廾
禬	示亼四日
袹	衤一白
衭	衤夫
襗	衤四土半
襋	衤木冂木冂
嫮	女雨一丂
嫮	女雨丂一
綌	糸八人口
琔	王宀一止
珢	王艮
挃	扌至
拸	扌夕夕
薕	艹广禾禾彐
碡	石丰母
蝘	虫匚日女
唗	口走
鋘	金口一大
鋘	金口乚大
鋘	金口乚廾
鈶	金厶口
膕	月圍戈口一
肕	月刀丶
痁	疒卜口
痟	疒小月
憪	心門月
宧	宀臣
櫜	一中冖夂卜口木
坋	土八刀
埢	土半卩
鷇	士冖一鳥殳
畺	三田田
髽	長彡人人土
鬋	長彡䒑月刂
鬅	長彡月月
髴	長彡弓刂
耞	耒力口
騇	馬亼十口
揳	扌丰刀大
鞳	革艹亼口
蔾	艹禾丿刀木
蓨	艹亻丨夂月
蓨	艹亻丨攵月
薝	艹𠂊厂八言
芛	艹尹
蘟	艹阝爪工彐心
橾	木口口口木
軑	車大
輵	車日勹亡
朳	木八
橧	木八四日
橧	木八田日
梡	木宀一兀
槢	木习习白
礛	石臣𠂉丶皿
礛	石臣𠂉一皿
豷	豕士冖一口䒑
礒	石羊手戈
哳	口扌斤
跱	足土寸
踖	足廿日
踾	足一口田
踛	足土儿土
踛	足土八土
鼈	巾⺍攵黽
罿	四立田土
睌	目召儿
穟	禾之八豕
箯	竹亻一日乂
躾	身羊大
魌	鬼甘廾
伭	亻亠幺
畣	亼口田
彾	行亼卩
彾	行亼龴
膴	月𠂉廿廿火
狢	犭夂口
雑	九木隹
觭	𠂊用大丁口
鶁	亠口小鳥
帟	大八巾
凔	冫人户口
痷	疒大申
痗	疒𠂉母
愒	心日勹亡
煟	火田月
濳	氵牛儿牛儿日
滫	氵亻丨夂月
滫	氵亻丨攵月
戺	户巳
穽	穴二刂
袵	衤亻工一
袵	衤亻丿士
袾	衤𠂉木
袟	衤手丶
矠	予丿廿日
纒	糸厂田土火土
妦	女丰
嫴	女十口辛
媢	女日目
媢	女冖二目
梩	木田土
呥	口冂土
嵥	山夕㐄木
釽	金爪
諕	言虎
恇	心匚王
忺	心欠
抎	扌二厶
搊	扌勹屮勹屮
拹	扌力力力
靱	革刀丶
苉	艹匚儿
薐	艹禾土儿夂
薐	艹禾土八夂
蘤	艹白爲
檝	木口耳戈
欉	木业半耳又
鸉	木日一勿鳥
霨	雨尸示寸
豝	豕巴
磜	石䏑又示
螋	虫臼丨又
齸	齒䒑八皿
哱	口十冖子
唣	口白七
颽	山一口䒑風
簗	竹氵刀八木
齇	自田廾虎且
猨	犭爪一𠂇又
猇	犭虎
粂	𠂊丶米
齌	齊火
秶	二欠禾
秶	冫欠禾
廘	广鹿
懁	心四一口衤
熯	火廿口夫
熯	火艹口夫
盓	氵丁一皿
溔	氵羊火
慂	氵龴用心
袺	衤士口
邥	冖儿阝
衋	彐キ一白一白丿皿
閈	門干
弨	弓召
帤	女口巾
嫶	女隹火
繂	糸亠幺⺍十
俇	亻犭王
僎	亻巳巳艹廾
搫	舟殳手
朒	月䏑
痄	疒𠂉匕
埳	土𠂊臼
埣	土亠人人十
塀	土尸䒑廾
聑	耳耳
駹	馬尤彡
驏	馬尸子子子
摲	扌車斤
摓	扌之夂丰
莝	艹人人土
薶	艹豸田土
蘱	艹米犬頁
藋	艹习习隹
輑	車尹口
軷	車犬丿
軷	車犬㇕
柍	木冂大
桼	木人水
磌	石十目廾
磌	石匕目廾
磹	石西日十
嫛	匚矢殳女
暶	日方𠂉足
黫	四土火西土
黫	田土火西土
歜	四勹虫欠
岝	山𠂉匕
嶦	山𠂊厂八言
牼	牛一巛工
氠	气申
偫	亻行土寸
讆	行㐄口㐄言
彸	行八厶
巵	𠂆一巴
獩	犭止戊一癶
猫	犭艹田
猼	犭甫寸
鯰	魚亼㇕心
韹	立日白王
斻	方𠂉几
鄌	广尹口阝
爌	火广廿由八
渿	氵木示
硰	氵小丿石
渰	氵亼口廾
寍	宀心皿
衱	衤𠂊又
隮	阝齊
隒	阝禾禾彐
盄	丨弓皿
琫	王丰キ
扜	扌丁一
茷	艹亻戈
柧	木瓜
暰	日行人人止
穬	禾广廿由八
餧	食禾女
鎃	金氵𠂆亻
胻	月行
魛	魚刀
翿	士㇕工一口寸习习
耹	耳亼㇕
搘	扌耂匕日
搕	扌土厶皿
苀	艹亠几
醂	酉木木
軓	車凡
軧	車氏一
軧	車氏丶
楥	木爪一𠂇又
霠	雨立亼㇕
砆	石夫
毉	匚矢殳工人人
蠏	虫𠂊用刀牛
啑	口一彐止
蹢	足亠八冂十口
鴠	日一鳥
昢	日屮凵
帢	巾亼口
罧	四木木
髆	骨甫寸
鄦	𠂉廿廿火阝
犌	牛尸二コ又
礜	臼一乚丨廾石
僄	亻西示
俋	亻口巴
鄃	亼月刂阝
鄃	亼月巛阝
徛	行大丁口
谹	八人口𠂇厶
錭	金用口
鯵	魚厶大彡
羓	羊巴
煠	火廿乚木
瀸	氵人人戈非一
潠	氵巳巳艹廾
寱	宀爿自木
窵	穴鳥
禗	示田心
闚	門夫見
劀	予丿冂儿口刂
劀	予丿冂八口刂
纎	糸十戈非一
塼	土一日厶寸
莏	艹扌小丿
荓	艹䒑廾
芀	艹刀
俔	亻見
倠	亻隹
胵	月至
誂	言儿⺍
痀	疒勹口
赩	土火𠂊巴
壿	士八酉寸
璊	王廿巾人人
驒	馬口口甲一
馰	馬勹丶
抶	扌手丶
蓺	艹土儿土丸
蓺	艹土八土丸
藇	艹臼一乚丨廾
虀	艹齊非一
翲	西示习习
龗	雨口口口龍
樒	木宀弋八山
鴎	匚乂鳥
翽	止戊一癶习习
嚘	口一白冖心夂
剕	非刂
晐	日亠凵人
岻	山氏一
岻	山氏丶
嶍	山习习白
箾	竹小月刂
餲	食日勹亡
鑢	金虎田心
玃	犭目目隹又
鱄	魚一日厶寸
觺	匕矢龴足𠂊用
鯒	魚龴用
臝	亡口月田木凡
毃	亠口冂口殳
廎	广匕頁
麞	鹿立日十
慱	心一日厶寸
禜	火火冖示
澁	氵止止止
淈	氵尸屮凵
袿	衤土土
褾	衤西示
襚	衤之八豕
褷	衤行止止
綟	糸户犬
綟	糸户大
堈	土冂䒑山
蕑	艹門月
枅	木一廾
霣	雨口貝
碈	石氏日
硍	石艮
蜼	虫隹
貤	貝也
猲	犭日勹亡
魬	魚厂又
魬	魚𠂆又
謑	言爪幺大
悺	心宀㠯
洭	氵匚王
阞	阝力
壻	土足月
髷	長彡曲
駜	馬弋八
挋	扌臣
抌	扌冖儿
撏	扌彐工口寸
蔏	艹亠八冂儿口
蔏	艹亠八冂八口
蘪	艹鹿米
橑	木一火日小
輀	車而
雽	雨爪丁
碔	石戈止
顑	戊一口頁
齯	齒臼儿
蜋	虫丶艮
螾	虫宀一由八
鄤	日四又阝
鄤	冖二四又阝
猒	日月犬
眐	目一止
嶊	山扌隹
岒	山亼㇕
巕	山䒑丿㠯辛子
嵙	山禾冫十
犞	牛丿大口冂口
牰	牛由
稰	禾足月
籯	竹亡口月貝凡
侻	亻八口儿
谽	八人口亼㇕口
猘	犭牛巾刂
腅	月火火
弮	半弓
爚	火亼口口口冊
窔	穴亠八乂
褯	衤广廿巾
袸	衤一亻子
闟	門亼口习习
隃	阝亼月刂
隃	阝亼月巛
弉	爿士廾
婤	女用口
緷	糸冖車
掗	扌亞
荁	艹二日
菵	艹冂䒑亡
欂	木艹氵甫寸
磎	石爪幺大
螖	虫骨
郋	自阝
鑐	金雨而
瘏	疒耂
泜	氵氏一
泜	氵氏丶
絇	糸勹口
聢	耳宀一止
琖	王戈戈
瑫	王爪臼
攩	扌小冖口四土火
攩	扌小冖口田土火
挧	扌习习
兡	十口儿一白
菨	艹立女
橖	木小冖口木
軥	車勹口
麰	木人人夂厶牛
柮	木屮凵
硲	石八人口
齰	齒廿日
踆	足厶八夂
踠	足宀夕卩
肙	口月
呟	口亠幺
蟞	巾⺍攵虫
鷩	巾⺍攵鳥
瞁	目目犬
郔	廴丿止阝
皭	白爪四艮寸
鑁	金乂凵八夂
狉	犭不一
魠	魚丿七
坒	匕匕土
譐	言八酉寸
麛	鹿弓耳
灈	氵目目隹
溵	氵𠂆彐㇕殳
澭	氵亠乚凵隹
潳	氵尸耂
鶱	宀甘八鳥
扅	户夕夕
閵	門隹
韥	㐄口㐄士四貝
屘	尸毛子
凾	了口又凵
凾	丂口又凵
彃	弓甲艹二
猪	犭耂
册	冊
葀	艹扌舌
跓	足丶王
尟	日一止小丿
旵	日山
郥	貝阝
侜	亻舟
鼸	臼釆禾禾彐
鉊	金召
魦	魚小丿
綑	糸圍木
趎	走𠂉木
擩	扌雨而
拤	扌上卜
靭	革刀丶
鄸	艹四冖夕阝
莚	艹廴丿止
葅	艹人人且
蘠	艹爿土人人圍口
轃	車丰禾
輹	車𠂉日夂
枍	木八丂
霬	雨田艹廾
礂	石士口䒑口
翈	甲习习
畇	田勹冫
畇	田勹二
峮	山尹口
甒	𠂉廿廿火瓦
犩	禾女鬼牛
鼪	臼釆生
敜	亼㇕心攵
鈎	金勹厶
獡	犭臼乚火
肣	月亼㇕
讔	言阝爪工彐心
瘭	疒西示
廐	广艮旡
痎	疒亠凵人
忨	心一兀
齹	羊工齒
糒	米廿丿用
爊	火鹿火
漹	氵一止一乚火
漰	氵山月月
禴	示亼口口口冊
闒	門日习习
鄝	习习人彡阝
揕	扌甘匚儿
揕	扌甘匚八
荴	艹扌夫
薙	艹矢隹
嘄	口鳥木
獶	犭一白冖心夂
悋	心文口
姼	女夕夕
髲	長彡皮
镼	長尸屮凵
瑲	王人户口
馺	馬𠂊又
珒	王彐キ
螒	十日十人虫
蕀	艹木冂木冂
藅	艹四言刂
蕠	艹女口糸
榑	木甫寸
樕	木木口欠
覂	西丿之
鑋	車一巛工金
輬	車亠口小
轇	車习习人彡
棭	木亠亻夂丶
顬	雨而頁
霿	雨予丿夂目
鄏	辰寸阝
躣	足目目隹
嘐	口习习人彡
曻	日夕㐄
骭	骨干
濌	千日土水日
稭	禾匕匕白
簥	竹丿大口冂口
傿	亻一止一乚火
鼫	臼釆石
齉	自田廾一中冖口口甘衤
忁	行日屮凵大水
膞	月一日厶寸
猯	犭山而
腒	月尸十口
邍	之夂田彐水
夗	夕卩
譸	言士㇕工一口寸
庲	广木人人
慉	心亠幺田
灪	氵午凵木木冖乂凵匕彡
窌	穴卯
祩	示𠂉木
嶞	阝𠂇工月山
楖	木艮卩
硾	石千艹二
呇	水口
氆	毛立立日
飋	風王王弋八
訹	言木丶
訹	言十儿丶
漘	氵辰月
皷	士口䒑皮
髳	長彡予丿
瑖	王厂三殳
駈	馬丘
騬	馬禾北
璸	王宀一癶貝
璚	王予丿冂儿口
璚	王予丿冂八口
揥	扌亠八冖巾
菎	艹日匕匕
葂	艹召儿力
槵	木中中心
欋	木目目隹
奅	大卯
碻	石亠口冂口
虴	虫丿七
踑	足甘廾
躙	足門隹
嗃	口亠口冂口
昦	日大刂
帩	巾小月
眒	目申
瞛	目行人人止
鼶	臼釆𠂆虎
雔	隹隹
牉	爿半
貒	豸山而
舽	舟夂㐄
狿	犭廴丿止
腶	月厂三殳
膌	月⺍人月
曶	勿日
皽	亠圍口日一皮
竫	立爪尹
竫	立𠂊尹
癗	疒雨田
劘	广木木非刂
劘	广十儿十儿非刂
慺	心婁
爔	火羊禾戈丂
慞	心立日十
淢	氵戈口一
汃	氵八
扊	户火火
袑	衤召
闛	門小冖口土
陓	阝大一丂
陓	阝大丂一
彄	弓匚口口口
斨	爿斤
縒	糸羊工
紽	糸宀匕
摝	扌鹿
剸	一日厶寸刂
硥	石尤彡
鴀	不鳥
蟭	虫隹火
虙	虎弋八
踶	足日一止
噅	口爲
覣	禾女見
鱴	魚艹四戈人
鱍	魚癶弓殳
詅	言亼卩
詅	言亼龴
痡	疒甫
愖	心甘匚儿
愖	心甘匚八
涍	氵耂子
澖	氵門木
鷊	一口冂八丁鳥
髾	長彡小月
摮	士方攵手
摮	土方攵手
摮	丰力攵手
騽	馬习习白
掝	扌戈口一
黇	廿由八卜口
疐	十冖田足
鞧	革八酉
胾	十戈䏑
蕋	艹止止止
藘	艹虎田心
蔨	艹圍半卩
薃	艹氵亠口冂口
柣	木手丶
梒	木亼㇕口
怷	十儿丶心
棳	木又又又又
覤	虎見
噳	口虎口一大
噳	口虎口乚大
噳	口虎口乚廾
唌	口廴丿止
噇	口立田土
晱	日火火
鸅	四土半鳥
崣	山禾女
穱	禾爪四艮寸
魖	鬼虎业
魖	鬼虎丘
匁	勹乂
歊	亠口冂口欠
籵	米十
瀎	氵艹四戈人
橤	心心心木
韍	㐄口㐄犬丿
韍	㐄口㐄犬㇕
屭	尸貝貝貝
翏	习习人彡
絏	糸申丿
蠁	乚凵丶艮阝虫
蠁	乚凵艮阝虫
扤	扌兀
荎	艹至
棷	木耳又
跧	足人王
肵	月斤
觼	𠂊用𠂊冂人目夂
忯	心氏
漦	二木攵厂水
壷	士冖刂口一
駼	馬亼木
馻	馬厶儿
薚	艹一夕日一勿
薉	艹止戊一癶
樲	木弋二貝
槾	木日四又
槾	木冖二四又
鶫	木四鳥
欃	木召匕匕召儿丶
霐	雨氵弓厶
梮	木尸㇕口
磿	厂禾禾石
礔	石尸口辛
瑿	匚矢殳王丶
蠎	虫艹大十艹
跦	足𠂉木
曣	日廿口北火
睖	目土儿夂
睖	目土八夂
逬	之丿干丿干
犑	牛目犬
犉	牛亠口子
籧	竹之虎豕
牏	爿亼月刂
牏	爿亼月巛
韽	亼㇕酉立日
鎉	金日习习
腢	月日冂厶
胏	月丿乚亻
鱊	魚予丿冂儿口
鱊	魚予丿冂八口
鯞	魚彐冖巾
鰼	魚习习白
鱳	魚白幺幺木
鸁	亡口月鳥凡
懅	心虎豕
濎	氵目爿爿
蠥	屮丿㠯辛虫
絖	糸小兀
机	木几
璥	王艹勹口攵
捁	扌牛口
椙	木日日
桵	木爪女
笲	竹厶廾
釴	金弋
陼	阝耂
鬷	一口冂八丁乂凵八夂
斄	二木攵厂木人人
趌	走士口
圠	土乚
聏	耳而
撗	扌廿由八
撌	扌中一貝
揟	扌足月
擽	扌白幺幺木
菆	艹耳又
鞿	革幺幺戈人
蟇	艹日大虫
鴱	艹乂鳥
醰	酉西日十
樠	木廿巾人人
槫	木一日厶寸
橝	木西日十
軱	車瓜
慙	車斤心
磝	石士方攵
磝	石土方攵
磝	石丰力攵
豶	豕十艹貝
蟷	虫小冖口田
蛈	虫手丶
蠰	虫衣口口甘
幖	巾西示
嶕	山隹火
岉	山勿
罏	午凵虎田皿
犗	牛宀丰口
穮	禾鹿火
舑	舌冂土
篹	竹目大卩
帠	臼巾
侇	亻大弓
膫	月一火日小
獝	犭予丿冂儿口
獝	犭予丿冂八口
鮖	魚石
鰐	魚口口一丂
鰐	魚口口丂一
欴	丶艮欠
羢	羊戈𠂇
懱	心艹四戈人
熂	火气米
爓	火門𠂊臼
洍	氵臣
鶷	宀丰口鳥
禂	示用口
邆	之癶一口䒑
隶	尹⺍
陾	阝而大
阰	阝匕匕
鶭	糸方鳥
坽	土亼卩
坽	土亼龴
蹔	車斤足
奫	大氵爿一爿
蠬	虫龍
犕	牛廿丿用
詑	言宀匕
浧	氵口王
浧	氵口亻土
沜	氵爿
歾	一夕勿
墐	土艹口丰
墐	土廿口丰
趮	走口口口木
赸	走山
鬙	長彡八四日
鬙	長彡八田日
謷	士方攵言
謷	土方攵言
謷	丰力攵言
剚	一中彐刂
靽	革半
蚅	虫厂卩
鮆	止匕魚
蟧	虫火火冖力
畟	田八夂
鴫	田鳥
曒	日白方攵
暲	日立日十
幨	巾𠂊厂八言
瞏	四土口衤
穖	禾幺幺戈人
稌	禾亼木
馞	禾日十冖子
簒	竹目大丿厶
鸒	臼一乚丨廾鳥
獌	犭日四又
獌	犭冖二四又
贕	卯丶丶士四貝
粊	匕匕米
鰞	魚烏
譪	言艹日勹亡
庉	广丿屮
庉	广一屮
羒	羊八刀
膋	火火冖月
惸	心勹日子
濿	氵厂艹日冂厶
灨	氵立日十夂工貝
竃	穴土黽
襂	衤厶厶厶人彡
隞	阝士方攵
隞	阝土方攵
隞	阝丰力攵
敶	阝木日攵
縅	糸戊一女
纑	糸虎田皿
繟	糸口口甲一
塴	土山月月
蓫	艹之豕
餫	食冖車
膇	月之丿㠯
湆	氵立日
襏	衤癶弓殳
堼	土土寸土
尌	士口䒑寸
珫	王亠厶儿
驞	馬宀一癶貝
薵	艹士㇕工一口寸
荺	艹土勹冫
荺	艹土勹二
靫	革又丶
虈	艹口口頁口口
苵	艹手丶
躠	艹丿㠯辛足
楲	木戊一女
樀	木亠八冂十口
匳	匚亼口口人人
蝒	虫頁圍
劋	口口口木刂
逿	之日一勿
羃	四艹日大巾
崰	山巛田
眅	目厂又
眅	目𠂆又
秮	禾厶口
峊	丿㠯山
鼵	臼釆穴犬
鬿	鬼斤
倹	亻亼口人
剱	亼口人刀丶
胈	月犬丿
胈	月犬㇕
玂	犭艹口口甲一斤
謋	言夕㐄木
廮	广貝貝女
燡	火四土半
恔	心亠八乂
灂	氵爪四艮寸
襮	衤日艹廾水
袶	衤夂㐄
韐	㐄口㐄亼口
頚	又土頁
緎	糸戈口一
掜	扌臼儿
碨	石田衤
蚄	虫方
暵	日廿口夫
暵	日艹口夫
篿	竹一日厶寸
鰶	魚䏑又示
詍	言廿乚
迾	之一夕刂
奊	土土乚大
瓡	土半瓜
刵	耳刂
騞	馬丰石
騜	馬白王
璒	王癶一口䒑
摎	扌习习人彡
蔪	艹車斤
蒧	艹戊卜口
醊	酉又又又又
軘	車丿屮
軘	車一屮
轠	車田田田
轞	車臣𠂉丶皿
轞	車臣𠂉一皿
桝	木夕㐄
奲	大耂口口甲一
蜨	虫一彐止
遉	之卜貝
喣	口勹口火
礨	田田田石
矘	目小冖口四土火
矘	目小冖口田土火
岪	山弓刂
骾	骨一日乂
矲	矢四厶月匕匕
穋	禾习习人彡
鳰	人鳥
歈	亼月刂欠
歈	亼月巛欠
艑	舟户冊
狫	犭耂匕
猈	犭鬼十
腏	月又又又又
爢	广木木非火
爢	广十儿十儿非火
麖	鹿亠口小
粁	米千
慛	心山隹
燗	火門月
漋	氵阝夂一生
禠	示𠂆虎
襛	衤曲辰
裺	衤大申
剭	尸至刂
媕	女亼口廾
搤	扌䒑八皿
膵	月艹亠人人十
癠	疒齊
碆	氵皮石
駥	馬戈𠂇
驉	馬虎业
驉	馬虎丘
摠	扌囟夂心
摠	扌囟丿乂心
勩	廿乚貝力
臡	廿口夫隹䏑
臡	艹口夫隹䏑
酳	酉幺月
樧	木乂木丶殳
樧	木乂十儿丶殳
礧	石田田田
卼	兀𠂊厂卩
磍	石宀丰口
顣	戊上小頁
朁	旡旡日
蠸	虫艹口口隹
蠨	虫艹尹爿一爿
跿	足走
躆	足虎豕
喭	口立丿彡
酅	山隹冂儿口阝
酅	山隹冂八口阝
缹	午凵火
鯬	禾丿刀魚
鬾	鬼十又
臲	自木𠂊厂卩
欱	亼口欠
韱	人人戈非一
犿	犭亠卜
鶀	鳥甘廾
庮	广酉
煣	火予丿木
閜	門丁口
楘	予丿攵木
翂	习习八刀
邿	土寸阝
撋	扌門王
蚇	虫尸丶
郘	口口阝
郘	口丿口阝
蹸	足米夕㐄
覛	𠂆亻見
膢	月婁
歍	烏欠
迒	之亠几
瘣	疒鬼
汱	氵犬
汦	氵氏
阤	阝也
趡	走隹
堩	土心二日
聝	耳戈口一
琡	王上小又
璅	王巛田木
抭	扌宀几
頍	十又頁
蔮	艹圍戈口一
薎	艹四冖亻戈
蕍	艹氵亼月刂
蕍	艹氵亼月巛
芵	艹㇕大
轗	車戊一口心
軞	車毛
檍	木立日心
鵸	大丁口鳥
鬳	虎一口冂八丁
蝯	虫爪一𠂇又
蛫	虫𠂊厂卩
蜛	虫尸十口
蠾	虫尸水四勹虫
跍	足十口
蹝	足行止止
朄	申木四
朄	申木日
晜	日弋弓
瞫	目西日十
篭	竹立申
饁	食土厶皿
鑕	金斤斤貝
覶	爪龴冂厶龴見
獿	犭頁止巳夂
腛	月尸至
鯲	魚方人冫
譺	言匕矢龴足
廧	广土人人圍口
鄁	北月阝
憢	心土土土兀
逤	之氵小丿
襣	衤自田廾
覭	冖日亠八見
鼏	冖目爿爿
鱀	艮旡魚
娙	女一巛工
鴽	女口鳥
趍	走夕夕
蕦	艹彡頁
碄	石木木
螁	虫之艮
虭	虫刀
蛁	虫召
罺	四巛田木
鈆	金八厶
縏	舟殳糸
鵔	鳥厶八夂
訿	言止匕
衵	衤日
郠	一日乂阝
壴	士口䒑
髠	長彡几
挬	扌十冖子
兙	十口儿十
莥	艹犭彐丨
欶	木口欠
欝	乂乂木木四艮寸
砐	石𠂊又
蟖	虫甘廾斤
瓽	小冖口瓦
嵺	山习习人彡
嵾	山厶厶厶人彡
骴	骨止匕
箚	竹亼口刂
笐	竹亠几
顖	囟心頁
傰	亻山月月
錻	金戈止
胘	月亠幺
鴥	鳥穴
斖	文臼冂一口冖且
齍	齊皿
癵	疒言糸糸䏑
懥	心十冖田足
爟	火艹口口隹
炾	火口儿
悷	心户犬
瀄	氵竹艮卩
澓	氵行𠂉日夂
襢	衤亠圍口日一
堾	土丰日
扨	扌刀丶
蛓	十戈虫
栂	木母
蛣	虫士口
蠉	虫四一口衤
鋄	金一火又
譝	言黽
翍	习习皮
鶝	一口田鳥
瑓	王木四
瑓	王木日
髺	長彡舌
駬	馬耳
瑵	王又冫虫
瑵	王又丶虫
擖	扌艹日勹亡
攭	扌彑豕虫虫
剒	廿日刂
葴	艹戊一口
芚	艹丿屮
芚	艹一屮
蓚	艹亻丨夂彡
蓚	艹亻丨攵彡
醓	酉冖儿皿
櫹	木艹尹爿一爿
輘	車土儿夂
輘	車土八夂
杁	木人
桹	木丶艮
鷞	大乂乂乂乂鳥
贙	虎虎貝
蹞	足匕頁
咉	口冂大
巏	山艹口口隹
嵲	山自木
崷	山八酉
矉	目宀一癶貝
犐	牛禾冫十
篎	竹目小丿
鵅	夂口鳥
鰜	魚禾禾彐
螤	文虫日人
漮	氵广尹⺍
漅	氵巛田木
縰	糸行止止
盭	幺土半攵皿
藄	艹甘廾糸
朼	木匕
磈	石鬼
跈	足人彡
巑	山牛儿牛儿貝
誻	言水日
鴐	力口鳥
陫	阝非
耾	耳𠂇厶
抪	扌𠂇巾
藲	艹木匚口口口
臷	十戈至
藈	艹目癶一大
蘬	艹丿㠯止彐冖巾
鵏	甫鳥
楕	木𠂇工月
椣	木冊廾
梴	木廴丿止
麷	木人人夂丰丰山一口䒑
蠠	頁圍虫虫
鵄	至鳥
蟟	虫一火日小
蠦	虫虎田皿
齖	齒牙
瞡	目夫見
稑	禾土儿土
稑	禾土八土
傂	亻𠂆虎
偯	亻衣口
蠫	豸刂虫虫
舼	舟艹廾
艐	舟乂凵八夂
鱵	魚竹戊一口
欿	𠂊臼欠
諔	言上小又
譈	言亠口子攵
廦	广尸口辛
鶊	广彐人鳥
渜	氵而大
溠	氵羊工
寁	宀一彐止
刔	㇕大刂
鵖	艮鳥
翪	习习乂凵八夂
縓	糸厂白小
絋	糸广厶
葟	艹白王
釱	金大
凩	几木
諓	言戈戈
豏	一口䒑禾禾彐
瓀	王雨而
蓻	艹土半丸
雗	十日十𠂉隹
苲	艹𠂉匕
蓎	艹广尹口
醶	酉亼口口人人
輲	車山而
梻	木亻弓刂
砄	石㇕大
貣	弋貝
齝	齒厶口
蹅	足木日一
嵅	山戊一口
甀	千艹二瓦
篞	竹氵日土
伜	亻九十
顩	亼口口人人頁
鎺	金示且
舩	舟八厶
膙	月弓口虫
膙	月弓厶虫
鵤	𠂊用鳥
袌	衣勹巳
怢	心手丶
怋	心巳七
懘	氵廿儿冖巾心
湨	氵目犬
阸	阝户乙
婘	女半卩
諅	甘廾言
梜	木大人人
砅	石水
硉	石彐キ
嵽	山廿儿冖巾
穨	禾几中一貝
泧	氵戈乚
溾	氵鬼
邧	一兀阝
镻	長手丶
鬄	長彡日勿
駪	馬牛儿
騉	馬日匕匕
薞	艹一夕食
蘡	艹貝貝女
釂	酉爪四艮寸
檕	車凵殳木
橅	木𠂉廿廿火
豥	豕亠凵人
尳	尤骨
齾	虎一口冂八丁犬齒
躟	足衣口口甘
踤	足亠人人十
鷕	口隹鳥
嚪	口門𠂊臼
啒	口尸屮凵
峞	山𠂊厂卩
秠	禾不一
轝	臼一乚丨廾車
鵀	亻工一鳥
鵀	亻丿士鳥
酓	亼㇕酉
忀	行衣口口甘
狾	犭扌斤
魳	魚一巾
鰋	魚匚日女
蝱	亡虫虫
謪	言亠八冂儿口
謪	言亠八冂八口
廅	广土厶皿
羛	羊弓刂
粭	米亼口
熰	火匚口口口
焍	火弋弓
襒	衤巾⺍攵
隺	冖隹
緅	糸耳又
螿	爿䏑寸虫
牄	爿人户口
緪	糸心二𠂊冫
坥	土且
馵	馬廾
搳	扌宀丰口
蘴	艹丰丰山一口䒑
蔜	艹士方攵
蔜	艹土方攵
蔜	艹丰力攵
芇	艹巾
萴	艹貝刂
枺	木一木
杝	木也
蛅	虫卜口
蝝	虫彑豕
暡	日八厶习习
狊	目犬
罼	四甲艹二
籗	竹雨隹
饎	食士口䒑口
鈌	金㇕大
臄	月虎豕
謰	言之車
詙	言犬丿
詙	言犬㇕
謱	言婁
愅	心革
怴	心戈乚
渨	氵田衤
淭	氵户木
顤	土土土兀頁
剺	二木攵厂刀
趬	走土土土兀
豰	士冖一豕殳
驔	馬西日十
騱	馬爪幺大
珕	王力力力
兝	十口儿八刀
鞈	革亼口
飌	艹口口隹風
蒭	艹勹屮勹屮
豵	豕行人人止
蟦	虫十艹貝
蚞	虫木
蛦	虫大弓
蜪	虫勹午凵
蟉	虫习习人彡
蹎	足十目廾
蹎	足匕目廾
噮	口四一口衤
嗺	口山隹
曮	日口口厂丁耳攵
曮	日口口厂㇕耳攵
罭	四戈口一
岏	山一兀
崵	山日一勿
睮	目亼月刂
睮	目亼月巛
籈	竹西土瓦
鄅	丿口冂厶阝
笰	竹弓刂
籊	竹习习隹
佒	亻冂大
貆	豸二日
媻	舟殳女
鄐	亠幺田阝
鶶	广尹口鳥
廥	广亼四日
糂	米甘匚儿
糂	米甘匚八
愃	心宀二日
慅	心又冫虫
慅	心又丶虫
澽	氵虎豕
淟	氵冊廾
濵	氵宀尸貝
鶣	户冊鳥
禒	示彑豕
裶	衤非
袀	衤勹冫
袀	衤勹二
扻	扌欠
槥	木丰丰彐
檥	木羊手戈
蝍	虫艮卩
哤	口尤彡
睊	目口月
矌	目广廿由八
筀	竹土土
鏙	金山隹
錎	金𠂊臼
腲	月田衤
膲	月隹火
肒	月丸
鄾	一白冖心夂阝
坱	土冂大
塯	土卯田
髶	長彡耳
黈	廿由八丶王
鞺	革小冖口土
蕇	艹口口甲一
菙	艹千艹二
菕	艹亼冊
梂	木十⺍丶
梐	木匕匕土
雺	雨予丿
蝿	虫黽
蚥	虫八乂
昒	日勿
鄨	巾⺍攵口巴
眃	目二厶
幧	巾口口口木
罻	四尸示寸
鷽	臼乂乂冖鳥
鄇	亻コ矢阝
衠	行十目廾
衠	行匕目廾
瓻	乂𠂇巾瓦
猳	犭尸二コ又
斒	文户冊
麚	鹿尸二コ又
羬	羊戊一口
燵	火之土羊
恌	心儿⺍
淊	氵𠂊臼
袉	衤宀匕
褄	衤一尹女
隲	阝小丿馬
睯	巳七攵目
嫥	女一日厶寸
妐	女八厶
撽	扌白方攵
杶	木丿屮
杶	木一屮
椳	木田衤
樏	木田糸
枆	木毛
鷐	日辰鳥
昈	日户
眓	目戈乚
罬	四又又又又
胹	月而
鸃	鳥羊手戈
鱦	魚黽
痑	疒夕夕
鄳	黽阝
塕	土八厶习习
塉	土⺍人月
嗀	士冖一口殳
憃	丰臼心
駴	馬戈廾
捵	扌冊廾
摿	扌人立日
蘁	艹王口口口口
鞜	革水日
葧	艹十冖子力
虌	艹巾⺍攵黽
藡	艹之亠八冂十口
鸏	艹宀一豕鳥
輤	車丰月
軮	車冂大
楰	木臼人
鶆	木人人鳥
奝	大用口
鵊	大人人鳥
礭	石雨隹
蟨	厂䒑屮欠虫
蟢	虫士口䒑口
蟃	虫日四又
蟃	虫冖二四又
齘	齒亻八
蝷	虫广䒑屮
蠽	小隹戈虫虫
幎	巾冖日亠八
峚	山大土
峗	山𠂊厂卩
雟	屮隹冂儿口
雟	屮隹冂八口
箆	竹冂人匕匕
筤	竹丶艮
簶	竹示彐水
獂	犭厂白小
糎	米厂田土
籾	米刀丶
謍	火火冖言
寠	宀婁
穾	穴丿大
祋	示殳
褼	衤西大巳
褼	衤西大卩
裮	衤日日
袡	衤冂土
鄍	冖日亠八阝
舝	㐄巛冖厶㐄
勠	习习人彡力
蛃	虫一冂人
踳	足丰日
昤	日亼卩
昤	日亼龴
麁	𠂊鹿
絭	半糸
懧	心宀心皿丁
邔	巳阝
攕	扌人人戈非一
拲	艹廾手
蘦	艹雨口口口
蘻	艹車凵殳糸
蘙	艹匚矢殳习习
蒏	艹冖酉
酘	酉殳
罊	車凵殳午凵
轐	車业半大
輆	車亠凵人
樴	木立日戈
霩	雨亠口子阝
厬	厂日夂卜口
豜	豕一廾
跲	足亼口
踒	足禾女
畖	田瓜
冔	冖二口丁一
矂	目口口口木
鴸	𠂉木鳥
穐	禾龜
籏	竹方𠂉甘廾
鶂	臼儿鳥
甈	自木瓦
觟	𠂊用土土
凓	冫西木
湠	氵山𠂇火
潝	氵亼口习习
韛	㐄口㐄廿丿用
鶸	弓冫弓冫鳥
綧	糸亠口子
圢	土丁
茙	艹戈𠂇
碫	石厂三殳
唒	口酉
徲	行尸水牛
鑮	金艹氵甫寸
釸	金夕
獑	犭車斤
悐	犭火心
鄡	鳥木阝
觬	𠂊用臼儿
怚	心且
垒	厶厶厶土
鳱	干鳥
趭	走隹火
擶	扌竹䒑月刂
韅	革日幺幺火
蔈	艹西示
蕛	艹禾弋弓
毄	車口殳
柹	木丿乚亻
梌	木亼木
麬	木人人皮
砿	石广厶
蠮	虫匚矢殳习习
剻	山月月刂
骫	骨丸
睕	目宀夕卩
篕	竹土厶皿
鵹	禾丿刀鳥
敿	丿大口冂口攵
毨	毛牛儿
簓	竹用口彡
伻	亻干八
儢	亻虎田心
豻	豸干
褹	衤土儿土丸
褹	衤土八土丸
膉	月䒑八皿
詄	言手丶
袲	衣夕夕
庪	广扌十又
廏	广白匕殳
麆	鹿且
烰	火爪子
懫	心斤斤貝
懻	心北田艹廾
瀫	氵士冖一糸殳
滱	氵宀一兀卜又
寙	宀瓜瓜
襩	衤士四貝
皹	皮冖車
螱	尸示寸虫
鶋	尸十口鳥
隓	阝𠂇工𠂇工
頨	习习頁
鶨	彑豕鳥
醙	酉臼丨又
蠳	虫貝貝女
螰	虫鹿
眲	目耳
簝	竹一火日小
餟	食又又又又
鯺	魚耂
湱	氵丰石
赨	土火虫
埓	土爪寸
壛	土門𠂊臼
郰	耳又阝
刌	寸刂
撜	扌癶一口䒑
蓲	艹匚口口口
醳	酉四土半
醷	酉立日心
檡	木四土半
楺	木予丿木
碅	石圍禾
韰	卜夕又非一
蝺	虫丿口冂厶
螑	虫自犬
黤	四土火大申
黤	田土火大申
峬	山甫
剬	山而刂
瞲	目予丿冂儿口
瞲	目予丿冂八口
垼	行殳土
鋺	金宀夕卩
峱	犭彐丨山
獽	犭衣口口甘
魧	魚亠几
譠	言亠圍口日一
韏	半㐄口㐄
煃	火大土土
煁	火甘匚儿
煁	火甘匚八
濣	氵十日十人冫十
溰	氵山一口䒑
宎	宀丿大
祑	示手丶
裖	衤辰
襭	衤士口頁
堲	艮卩土
嬽	女四丨一四乚大
琟	王隹
撊	扌門月
硱	石圍木
幩	巾十艹貝
觕	牛𠂊用
鯦	魚夂卜口
譀	言丁耳攵
譀	言㇕耳攵
恲	心䒑廾
阺	阝氏一
阺	阝氏丶
螜	士冖一殳虫
墱	土癶一口䒑
髬	長彡不一
鬎	長彡木口刂
鬖	長彡厶厶厶人彡
摦	扌大一丂瓜
摦	扌大丂一瓜
蘵	艹耳立日戈
樝	木虎且
轙	車羊手戈
甝	虎甘
蝚	虫予丿木
嚾	口艹口口隹
躩	足目目隹又
躈	足白方攵
嚃	口之四水
哅	口勹乂凵
獘	巾⺍攵犬
瞚	目宀一由八
劗	牛儿牛儿貝刂
篧	竹冖隹
狜	犭十口
顈	匕糸頁
蠯	广鬼十虫虫
熿	火廿由八
忰	心九十
漊	氵婁
汳	氵厂又
汳	氵𠂆又
灛	氵門口口甲一
甂	户冊瓦
窢	穴戈口一
飁	习习白風
羾	习习工
鄛	巛田木阝
縪	糸甲艹二
纗	糸山隹冂儿口
纗	糸山隹冂八口
妵	女丶王
嬥	女习习隹
瓵	厶口瓦
硩	扌斤石
硈	石士口
磼	石隹木
咠	口耳
噆	口旡旡日
鳻	八刀鳥
臅	月四勹虫
鞷	一口冂八丁革
赮	土火尸二コ又
鬫	鬥丁耳攵
鬫	鬥㇕耳攵
鬕	長彡艹日大
攡	扌亠乂凵冂厶隹
鷏	十目廾鳥
鷏	匕目廾鳥
鞆	革一冂人
茣	艹口一大
茣	艹口乚大
茣	艹口乚廾
蘥	艹亼口口口冊
蕧	艹行𠂉日夂
藭	艹穴身弓
櫡	木竹耂
棜	木方人冫
檖	木之八豕
蚹	虫亻寸
趷	足𠂉乙
甹	由丂
鸓	田田田鳥
毟	小丿毛
歂	山而欠
犈	牛半卩
傽	亻立日十
徿	行龍
鷭	釆田鳥
狋	犭示
肐	月𠂉乙
鯏	魚禾刂
鰝	魚亠口冂口
甋	亠八冂十口瓦
庴	广廿日
麎	鹿辰
憉	心士口䒑彡
潀	氵四亻
溌	氵癶二儿
裋	衤一口䒑
隇	阝戊一女
隑	阝山一口䒑
緆	糸日勿
嫷	女阝𠂇工月
縃	糸足月
玿	王召
捼	扌禾女
挩	扌八口儿
砎	石亻八
齫	齒圍木
穧	禾齊
鸔	鳥日艹廾水
鮹	魚小月
渹	氵勹言
鳺	夫鳥
鼜	士口䒑十又又冫虫
鼜	士口䒑十又又丶虫
趜	走勹米
駤	馬至
駽	馬口月
薽	艹西土瓦
荾	艹厶八夂
榙	木艹亼口
軵	車亻寸
椶	木乂凵八夂
鶠	匚日女鳥
黳	匚矢殳四土火
黳	匚矢殳田土火
蜌	虫匕匕土
曋	日西日十
矐	目雨隹
幝	巾口口甲一
帗	巾犬丿
帗	巾犬㇕
嶀	山雨一丂
嶀	山雨丂一
馧	禾日日皿
齀	自田廾瓦
鰴	行山一魚攵
饡	食牛儿牛儿貝
艓	舟廿乚木
羭	羊亼月刂
羭	羊亼月巛
覮	火火冖見
澅	氵彐キ田一
窱	穴亻丨夂木
窱	穴亻丨攵木
禭	示之八豕
闑	門自木
褽	尸示寸衣
鵽	又又又又鳥
鄪	弓刂貝阝
嬐	女亼口口人人
櫋	木自穴方
蛌	虫瓜
蟂	虫鳥木
螏	虫疒矢
徾	行山言攵
豍	一口䒑鬼十
鴶	士口鳥
駓	馬不一
鞹	革亠口子阝
蒪	艹甫寸
薧	艹亠口冖一夕匕
蕄	艹門心
枎	木夫
醼	酉廿口北火
輚	車戈戈
轑	車一火日小
霋	雨一尹女
礣	石艹四戈人
豤	豕艮
嚔	口十冖田厶止
跰	足䒑廾
啽	口亼口廾
晪	日冊廾
黖	四土火旡
黖	田土火旡
篶	竹一止一乚火
鄋	臼丨又阝
鸄	白方攵鳥
鵆	行鳥
艕	舟亠八冖方
鱏	魚西日十
庬	广尤彡
癪	疒禾丰貝
翷	米夕㐄习习
煝	火尸目
澞	氵虎口一大
澞	氵虎口乚大
澞	氵虎口乚廾
襫	衤大一白一白
顐	冖車頁
敪	又又又又攵
翑	习习勹口
緰	糸亼月刂
緰	糸亼月巛
坁	土氏
嚍	口尹一火皿
杗	亡木
懭	心广廿由八
鄑	一业日阝
鄑	二厶厶日阝
璬	王白方攵
馲	馬丿七
駖	馬亼卩
駖	馬亼龴
憼	艹勹口攵心
檪	木白⺍木
椔	木巛田
磃	石𠂆虎
碯	石巛囟
畭	田亼木
譻	貝貝言
髐	骨土土土兀
髊	骨羊工
稘	禾甘廾
秎	禾八刀
鷑	竹立鳥
錣	金又又又又
狑	犭亼卩
狑	犭亼龴
甔	𠂊厂言瓦
斪	勹口斤
諈	言千艹二
憛	心西日十
顲	火火亠圍口頁
憰	心予丿冂儿口
憰	心予丿冂八口
滜	氵白大十
祳	示辰
襹	衤一冂丶一冂丶鹿
鸐	习习隹鳥
軬	厶大車
蜤	木斤虫
蝐	虫日目
蝐	虫冖二目
鴅	冊丶鳥
鱐	魚尹爿一爿
翜	习习大人人
殟	一夕日皿
鼘	士口䒑十又爿一爿
鼀	土八黽
瞉	士冖一目殳
鬠	長彡亼四日
髼	長彡夂丰
蛪	丰刀虫
撠	扌十日十戈
蓩	艹予丿夂力
葌	艹女女女
磩	石戊上小
鬵	旡旡一口冂八丁
隿	弋隹
齞	齒口八
蠩	虫言耂
螛	虫宀丰口
跙	足且
嚵	口召匕匕召儿丶
晇	日大一丂
晇	日大丂一
睅	目日干
奰	四四四大
穛	禾隹火
稯	禾乂凵八夂
餝	食艹方
鏏	金丰丰彐
鵃	舟鳥
劖	召匕匕召儿丶刂
鸗	龍鳥
羠	羊大弓
糷	米艹門木四
糷	米艹門木日
燖	火彐工口寸
焆	火口月
烑	火儿⺍
惼	心户冊
糪	尸口辛米
陭	阝大丁口
繉	糸目儿⺍
媆	女而大
挏	扌冂一口
鵛	一巛工鳥
胉	月白
鮅	魚弋八
墆	土廿儿冖巾
趏	走舌
鞻	革婁
荅	艹亼口
橭	木十口辛
桋	木大弓
軶	車户乙
蜳	虫亠口子
跮	足至
遻	之口口䒑屮
畽	田千日土
黕	四土火冖儿
黕	田土火冖儿
峌	山至
崺	山方也
眝	目宀丁
篏	竹甘欠
秅	禾丿七
簔	竹衣二艹
篣	竹亠八冖方
鼮	臼釆廴工一
鼮	臼釆廴丿士
鼮	臼釆廴亻土
皫	白鹿火
鄎	自心阝
餢	食立口
鎭	金匕目廾
鶢	爪一𠂇又鳥
艛	舟婁
衁	亡丿皿
帣	半巾
羜	羊宀丁
瀴	氵貝貝女
翐	习习手丶
刜	弓刂刂
圲	土千
耴	耳乚
揘	扌白王
掽	扌立立
磛	車斤石
楎	木冖車
蚼	虫勹口
号	口丂
簂	竹圍戈口一
馣	禾日大申
仜	亻工
鮿	魚耳乚
邟	亠几阝
矕	言糸糸目
颪	下風
殦	一夕鳥
鼛	士口䒑十又夂卜口
墋	土厶厶厶人彡
蛬	艹廾虫
酀	廿口北火阝
蔧	艹丰丰彐
靪	革丁
莌	艹八口儿
蒮	艹冖隹
榬	木土口衤
橲	木士口䒑口
櫼	木人人戈非一
栚	木䒑大
蝡	虫而大
豦	虎豕
齱	齒耳又
螪	虫亠八冂儿口
螪	虫亠八冂八口
欭	圍大欠
躖	足幺幺二幺幺丨
噞	口亼口口人人
毼	日勹亡毛
籉	竹士口冖至
簼	竹扌甘冂土
鑓	金之中一㠯
豽	豸冂人
飉	風一火日小
獀	犭臼丨又
觰	𠂊用耂
觩	𠂊用十⺍丶
譑	言丿大口冂口
艵	䒑廾𠂊巴
慔	心艹日大
熕	火工貝
熚	火甲艹二
鴬	⺍冖鳥
寉	宀隹
裧	衤火火
弣	弓亻寸
扑	扌卜
霮	雨氵甘匚儿
霮	雨氵甘匚八
蚻	木乚虫
蛖	虫尤彡
蛢	虫䒑廾
膹	月十艹貝
鰿	魚丰貝
魾	魚不一
誫	言辰
聈	耳幺力
鬊	長彡丰日
鬤	長彡衣口口甘
抏	扌一兀
攍	扌亡口月女凡
藀	艹火火冖火
櫰	木衣四水
厒	厂午凵
蛚	虫一夕刂
辴	口口甲一辰
稒	禾圍十口
鼳	臼釆目犬
齃	自田廾日勹亡
貛	豸艹口口隹
謥	言囟夂心
謥	言囟丿乂心
痸	疒牛巾刂
郱	䒑廾阝
羵	羊十艹貝
麊	米鹿
窙	穴耂子
陎	阝𠂉木
嬎	女召儿生
摍	扌宀亻一白
鏬	金虎爪丁
涾	氵水日
騺	土半丸馬
鼁	土厶黽
鬌	長彡𠂇工月
驖	馬十戈口王
驖	馬十戈口亻土
捘	扌厶八夂
荳	艹一口䒑
兣	十口儿厂田土
蘉	艹四冖亻彐冖又
藫	艹氵西日十
藬	艹阝中一貝
梬	木由丂
礥	石臣又貝
螐	虫烏
蜧	虫户犬
踸	足甘匚儿
踸	足甘匚八
跜	足尸匕
唈	口口巴
喢	口千臼
斀	四勹虫卜又
嶚	山一火日小
躽	身匚日女
軈	身广亻隹心
偋	亻尸䒑廾
舮	舟户
浲	氵夂丰
竁	穴毛毛毛
氄	予丿冂儿口毛
氄	予丿冂八口毛
彋	弓四一口衤
媰	女勹屮勹屮
纐	糸亠八乂頁
葞	艹弓耳
鷒	一日厶寸鳥
朻	木凵
覝	干火見
坅	土亼㇕
擉	扌四勹虫
郣	十冖子阝
蘣	艹廿由八丶王
櫅	木齊
樔	木巛田木
蠝	虫田田田
蚢	虫亠几
毾	日习习毛
崨	山一彐止
舕	舌火火
僓	亻中一貝
譥	白方攵言
敆	亼口卜又
銲	金日干
鋊	金八人口
臕	月鹿火
訰	言丿屮
訰	言一屮
怲	心一冂人
烻	火廴丿止
袕	衤穴
蟴	甘廾斤虫
篻	竹西示
鮛	魚上小
觻	𠂊用白幺幺木
濜	氵尹一火皿
紖	糸弓丨
麉	干干鹿
虣	戈止虎
鬁	長彡禾刂
駾	馬八口儿
騢	馬尸二コ又
蘜	艹革勹米
蔖	艹虎且
藑	艹𠂊冂人目夂
蔒	艹尹口火
蒘	艹女口手
磤	石𠂆彐㇕殳
蛂	虫犬丿
蛂	虫犬㇕
螇	虫爪幺大
嚊	口自田廾
巆	山火火冖口口
巆	山火火冖口丿口
巀	山小隹戈
嵣	山广尹口
嶭	山丿㠯辛
眣	目手丶
儥	亻士四貝
狘	犭戈乚
獧	犭四一口衤
竘	立勹口
黂	广木木十艹貝
黂	广十儿十儿十艹貝
羺	羊雨而
烓	火土土
灟	氵尸水四勹虫
阠	阝乙十
虋	艹臼冂一口冖酉八刀
杢	木工
蚫	虫勹巳
嵱	山穴人口
刱	二刂刀八
槷	土儿土丸木
槷	土八土丸木
搹	扌一口冂八丁
攇	扌宀丰四心
麶	木人人夂亠乂凵冂厶
磪	石山隹
蜠	虫圍禾
蜁	虫𠂉足
馦	禾日禾禾彐
筡	竹亼木
觡	𠂊用夂口
駂	匕十馬
濴	氵火火冖水
鳵	乙十鳥
螴	阝木日虫
葋	王艹王勹口
柖	木召
趹	足㇕大
嶜	山旡旡日
矏	目自穴方
顉	金頁
鮴	魚亻木
謯	言虎且
熉	火口貝
蟗	一中冖屮凵虫
趪	走廿由八
髱	長彡勹巳
揨	扌亠口冖丁
鼖	十艹士口䒑十又
蕵	艹夕食
萒	艹亠八厶儿
醗	酉癶二儿
蜲	虫禾女
蟤	虫巳巳艹廾
嘾	口西日十
踃	足小月
稫	禾一口田
觷	臼乂乂冖𠂊用
鼥	臼釆犬丿
鼥	臼釆犬㇕
鼤	臼釆文
跾	亻丨夂足
跾	亻丨攵足
鳹	亼㇕鳥
瓫	八刀瓦
逓	之𠂆二巾
胅	月手丶
庰	广䒑廾
炌	火亻八
灗	氵虫亠圍口日一
鶌	尸屮凵鳥
橉	木米夕㐄
飺	止匕食
鱁	魚之豕
鰫	魚穴人口
圫	土丿七
鵱	土儿土鳥
鵱	土八土鳥
鬗	長彡廿巾人人
觢	丰刀𠂊用
兞	十口儿毛
鞊	革士口
榰	木耂匕日
栜	木木冂
螹	虫車斤
齥	齒申丿
囆	口艹日冂厶虫
躨	足八頁止巳夂
嗋	口力力力月
嶱	山艹日勹亡
睔	目亼冊
聟	矢口耳
鷮	丿大口冂口鳥
鼣	臼釆犬
傮	亻一曲日
皏	白䒑廾
鵗	乂𠂇巾鳥
瞂	𠂆十目犬丿
瞂	𠂆十目犬㇕
瓝	瓜勹丶
猏	犭户月
臇	月隹冂凵
鷷	八酉寸鳥
恞	心大弓
涆	氵日干
褅	衤亠八冖巾
顄	丂⺍凵頁
顄	了⺍凵頁
鳭	刀鳥
翨	习习日一止
跇	足廿乚
甖	貝貝瓦
嶬	山羊手戈
鼲	臼釆冖車
飶	食弋八
鱞	魚四一口衤
痯	疒宀㠯
趓	走几木
驨	馬山隹冂儿口
驨	馬山隹冂八口
摏	扌丰臼
韇	革士四貝
茦	艹木冂
鷋	艹亼木鳥
萲	艹爪一𠂇又
醥	酉西示
軯	車干八
輷	車勹言
蜬	虫丂⺍凵
蜬	虫了⺍凵
踥	足立女
鄵	口口口木阝
睼	目日一止
嶟	山八酉寸
眑	目幺力
揫	禾火手
筄	竹儿⺍
僁	亻釆心
貜	豸目目隹又
猣	犭乂凵八夂
鱢	魚口口口木
頯	䏑廾頁
謞	言亠口冂口
竏	立千
麜	鹿西木
麔	鹿夂卜口
顅	户月頁
裷	衤半卩
鵋	巳心鳥
婟	女圍十口
茥	艹土土
矹	石兀
汆	人水
膆	月丰糸
憴	心黽
欯	士口欠
塓	土冖日亠八
聇	耳一止
馽	馬中
醹	酉雨而
蚲	虫干八
蜐	虫土厶力
蟘	虫亻弋貝
蜦	虫亼冊
矔	目艹口口隹
幭	巾艹四戈人
嵷	山行人人止
峉	山夂口
嶡	山厂䒑屮欠
毰	毛立口
傚	亻亠八乂攵
屔	丘尸匕
朡	月乂凵八夂
鷛	广尹用鳥
瀔	氵士冖一禾殳
渳	氵弓耳
覕	弋八見
嬓	女白方攵
垘	土亻犬
蝁	亞虫
梇	木王廾
鄟	一日厶寸阝
痝	疒尤彡
殱	一夕十戈非一
鶈	一尹女鳥
邞	夫阝
趥	走八酉
镺	長丿大
駍	馬干八
驠	馬廿口北火
搚	扌力力力月
歕	十艹貝欠
蒬	艹冖召儿丶
鷘	木口攵鳥
楾	木白水
槉	木疒矢
齴	齒立丿彡
蝬	虫乂凵八夂
蝑	虫足月
嘕	口一止一乚火
謈	日艹廾言
鷜	婁鳥
嵑	山日勹亡
岤	山穴
峐	山亠凵人
鴔	丿之鳥
鎒	金辰寸
觤	𠂊用𠂊厂卩
觙	𠂊用𠂊又
誙	言一巛工
鶙	亠八冖巾鳥
塺	广木木土
塺	广十儿十儿土
庱	广土儿夂
庱	广土八夂
懤	心士㇕工一口寸
糔	米又冫虫
糔	米又丶虫
煔	火火卜口
瀖	氵雨隹
祒	示召
蠿	幺幺二幺幺丨虫虫
隤	阝中一貝
糱	屮丿㠯辛米
玤	王丰
枦	木户
蜙	虫木八厶
釼	金刀丶
颬	風牙
戃	心小冖口四土火
戃	心小冖口田土火
寋	宀甘八卩
轖	車土人人圍口
檹	木方𠂉丁口
鴮	大一丂鳥
鴮	大丂一鳥
矺	石丿七
匷	匚目目隹
刞	且刂
眱	目大弓
龤	亼口口口冊匕匕白
艪	舟魚日
臐	月千四二火
膱	月立日戈
惾	心乂凵八夂
灖	氵广木木非
灖	氵广十儿十儿非
鼊	尸口辛黽
弴	弓亠口子
彏	弓目目隹又
蜄	虫辰
鴩	手丶鳥
蛗	丿㠯虫
兛	十口儿千
韄	革艹隹又
蒫	艹羊工
轈	車巛田木
裻	上小又衣
螔	虫𠂆虎
噊	口予丿冂儿口
噊	口予丿冂八口
雂	亼㇕隹
躗	行㐄口㐄足
鐀	金中一貝
鵌	鳥亼木
殶	丶王殳
麡	鹿齊
醟	火火冖酉
濭	氵艹土厶皿
濦	氵爪工彐心
襷	衤臼一乚丨廾手
朾	木丁
餪	食而大
怬	心四
蒆	艹工凡女
鞃	革弓厶
菣	艹臣又
蔩	艹宀一由八
葈	艹厶口木
蛷	虫十⺍丶
蚙	虫亼㇕
嘝	口𠂊用冫十
岯	山不一
缿	午凵𠂆一口
斔	文虫臼人
剆	丶艮刂
旞	方𠂉之八豕
熐	火冖日亠八
郼	㐄口㐄阝
憵	尸口辛心
顟	习习人彡頁
縜	糸口貝
鴢	幺力鳥
攗	扌鹿米
柫	木弓刂
踕	足一彐止
嘳	口中一貝
趀	走丿乚亻
珱	王⺍女
藣	艹四厶月匕匕
欘	木尸水四勹虫
袃	七刀衣
螶	匚コ虫虫
顪	止戊一癶頁
齺	齒勹屮勹屮
翢	用口习习
峷	山辛
岮	山宀匕
爂	臼冂一口冖火
豼	豸匕匕
鰖	魚𠂇工月
毈	卯丶丶厂三殳
觓	𠂊用凵
鷾	立日心鳥
罋	亠乚凵隹午凵
觠	半𠂊用
襳	衤人人戈非一
赶	走干
蜸	臣又虫
饙	食十艹貝
鎎	金气米
獛	犭业半大
謕	言𠂆虎
鞂	革禾
藗	艹之木口欠
鷣	西日十鳥
鷢	厂䒑屮欠鳥
蝛	虫戊一女
蝹	虫日皿
鷤	口口甲一鳥
揱	小月刂手
昲	日弓刂
遾	之竹工人人
筺	竹匚王丶
鼺	臼釆田田田
斞	臼人冫十
谾	八人口穴工
膟	月亠幺⺍十
烶	火廴工一
烶	火廴丿士
烶	火廴亻土
韟	㐄口㐄白大十
瞇	目之米
槃	舟殳木
蓾	艹卜圍乂
藃	艹亠口冂口欠
鷅	西木鳥
霵	雨口耳戈
蟔	虫四土火
蟔	虫田土火
蠷	虫目目隹
齻	齒十目廾
齻	齒匕目廾
贆	貝犬犬犬
髍	骨广木木
髍	骨广十儿十儿
顝	骨頁
刉	𠂉乙刂
衈	丿皿耳
譇	言大耂
黀	广木木耳又
黀	广十儿十儿耳又
麠	鹿三田田
瀢	氵之中一貝
漇	氵行止止
鶟	穴犬鳥
屖	尸辛
苬	艹圍人
駷	馬木口
裚	扌斤衣
轛	車业羊寸
蠜	乂乂木木大虫
礝	石雨而
豟	豕户乙
砨	石户乙
欳	卜冊欠
顋	田心頁
峅	山厶廾
鼭	臼釆土寸
倇	亻宀夕卩
鵵	召儿丶鳥
螷	广鬼十虫
襓	衤土土土兀
幦	尸口辛巾
鶅	巛田鳥
鴘	厶廾鳥
蝫	虫耂
曭	日小冖四土火
曭	日小冖田土火
簢	竹門文
艀	舟爪子
瀩	氵禾几頁
祐	示𠂇口
馯	馬干
騥	馬予丿木
揯	扌心二𠂊冫
薂	艹白方攵
遳	之艹人人土
轚	車凵殳車
欈	木山隹冂儿口
欈	木山隹冂八口
橳	木月半力
虪	虎亻丨夂四土火
虪	虎亻丨攵四土火
虪	虎亻丨夂田土火
虪	虎亻丨攵田土火
蝭	虫日一止
蝖	虫宀二日
躤	足艹耒廿日
氁	毛艹日大
貏	豸鬼十
魻	魚甲
浶	氵宀牛
祪	示𠂊厂卩
鉹	金夕夕
譋	言門月
雈	卜卜隹
燅	土儿土火火
燅	土八土火火
騹	馬艹口丰
騹	馬廿口丰
攌	扌圍四一口衤
菞	艹禾丿刀
橨	木十艹貝
榽	木爪幺大
骿	骨䒑廾
齂	自田廾尹⺍
鶞	𠂆十目鳥
貗	豸婁
讄	言田田田
旝	方𠂉亼四日
瀱	氵四厂火火刂
鄈	癶一大阝
蝞	虫尸目
饇	食匚口口口
戄	心目目隹又
孷	二木攵厂子
焣	耳又火
驈	馬予丿冂儿口
驈	馬予丿冂八口
蘳	艹廿由八土土
蕱	艹禾小月
楈	木足月
跠	足大弓
暆	日方𠂉也
黭	四土火亼口廾
黭	田土火亼口廾
螸	八人口欠虫
貄	豸彐キ
貀	豸屮凵
鱹	魚艹口口隹
觲	𠂊用羊牛
頝	亠八乂頁
廜	广尸耂
窑	穴午凵
弤	弓氏一
弤	弓氏丶
鉠	金冂大
鮵	魚八口儿
騴	馬日宀女
擨	扌𠂆虎欠
攐	扌宀甘八衣
橶	木十日十戈
鵫	卜日十鳥
岟	山冂大
犣	牛巛圍乂巛
穙	禾业半大
鵴	勹米鳥
謒	言人户口
麙	鹿戊一口
毲	又又又又毛
蚸	虫斤丶
殥	一夕宀一由八
皾	士四貝皮
镽	長一火日小
驆	馬甲艹二
萰	艹木四
萰	艹木日
蓌	艹人人土夂
榹	木𠂆虎
蹥	足之車
簎	竹扌廿日
謘	言尸辛
袬	衣厶口
糫	米四一口衤
籸	米乙十
韕	㐄口㐄亠口子
縚	糸爪臼
鳿	王鳥
歋	𠂆虎欠
諚	言宀一止
紎	糸犬
絼	糸豸
螼	虫艹口丰
螼	虫廿口丰
歶	止匕日冂厶
蠌	虫四土半
嚽	口士方攵貝
嚽	口土方攵貝
嚽	口丰力攵貝
踓	足隹
簅	竹立丿生
鼨	臼釆夂冫
衒	行亠幺
鱶	魚羊丶艮
譣	言亼口口人人
韲	齊非一
鵧	䒑廾鳥
甐	米夕㐄瓦
裍	衤圍木
緧	糸八酉
蜵	虫爿一爿
鸍	一八巾乂乂乂乂鳥
瓋	王之亠八冂十口
豱	豕日皿
顊	丿㠯十頁
鷎	白大十鳥
鸙	亼口口口冊鳥
餯	食彑豕
鮬	魚大一丂
鮬	魚大丂一
譨	言曲辰
濻	氵阝中一貝
鴾	厶牛鳥
听	口斤
柠	木宀丁
賟	貝冊廾
猬	犭田月
猎	犭廿日
疴	疒丁口
凄	冫一尹女
疱	疒勹巳
遡	之䒑屮月
糇	米亻コ矢
攳	十又彐工口寸
蘌	艹行午止卩示
虃	艹氵人人戈非一
椁	木亠口子
蟙	虫立日戈
郹	目犬阝
毤	八厶儿毛
貁	豸穴
猑	犭日匕匕
鶛	匕匕白鳥
竀	穴一止見
蛝	虫艮
貕	豸爪幺大
魱	魚一彑
鮤	一夕刂魚
鬞	長彡曲辰
蕮	艹臼勹火
蹗	足鹿
貾	貝氏一
貾	貝氏丶
痚	疒耂子
溛	氵穴瓜
疀	巛田一彐止
榩	木虎文
笻	竹工卩
靗	丰月小兀
攓	扌宀甘八足
靲	革亼㇕
麧	木人人夂𠂉乙
瞝	目亠乂凵冂厶
犥	牛鹿火
瓾	禾女瓦
觾	𠂊用廿口北火
羳	羊釆田
韗	㐄口㐄冖車
鷵	尸耂鳥
鞪	予丿攵革
桏	木工阝
胊	月勹口
藆	艹宀甘八手
豯	豕爪幺大
箈	竹氵厶口
郺	夕夕巛口巴
涄	氵由丂
鵳	户月鳥
鶔	予丿木鳥
蔰	艹户口巴
迺	之西
鶐	之木丶鳥
鶐	之十儿丶鳥
蝆	虫卜卜キ
蜭	虫𠂊臼
賌	亠凵人貝
瘱	疒大人人心
蠤	八酉虫虫
軝	車氏
蹪	足中一貝
郻	目乚巛阝
欨	勹口欠
覢	火火見
窲	穴米冫十
翇	习习犬丿
翇	习习犬㇕
孈	女山隹冂儿口
孈	女山隹冂八口
鼰	臼釆貝
蘮	艹四厂火火刂
毻	𠂇工月毛
蝔	虫匕匕白
蠗	虫习习隹
銔	金不十
旚	方𠂉西示
虇	艹弓艹口口隹
鶜	艹予丿鳥
蟡	虫爲
襺	衤艹冂糸丨虫
鰬	魚虎文
蘛	艹甘匚儿亠厶月
蘛	艹甘匚八亠厶月
桙	木厶牛
雓	亼木隹
讂	言𠂊冂人目夂
轏	車尸子子子
蛵	虫一巛工
齤	半齒
酟	酉卜口
嶩	山曲辰
鱋	魚虎业
鱋	魚虎丘
痻	疒氏日
瓲	瓦丿屮
瓲	瓦一屮
霤	雨卯田
祼	示田木
踍	足耂子
蹳	足癶弓殳
矎	目𠂊冂人夂
餰	食行氵
痺	疒鬼十
蛶	虫爪寸
踙	足耳又
羷	羊亼口口人人
窏	穴氵丁一
縯	糸宀一由八
証	言一止
晋	一业日
騣	馬乂凵八夂
惷	丰日心
藱	艹疒鬼
踂	足耳乚
酁	召匕匕召儿丶阝
冮	冫工
羦	羊宀一兀
壾	士口䒑匚コ
殔	一夕尹⺍
臙	月廿口北火
篲	竹丰丰彐
鴈	厂亻鳥
藚	艹士四貝
鷻	鳥亠口子攵
眦	目止匕
亘	二日
甪	丿用
蔆	艹氵土儿夂
蔆	艹氵土八夂
姪	女至
壼	士冖亞
踫	足立立
痴	疒矢口
砲	石勹巳
珮	王几一巾
駮	馬亠八乂
鄻	夫夫車阝
舗	人土口甫
﨑	山亠八丁口
叙	亼木又
离	亠乂凵冂厶
痲	疒十儿十儿
綉	糸禾㇕丿
虱	乙丿虫
籥	竹亼口口口冊
繙	糸釆田
揹	扌北月
滚	氵衣八厶
玅	亠幺小丿
玆	亠幺亠幺
攷	丂攵
査	木且
昵	日尸匕
屉	尸廿乚
倣	亻方攵
觝	𠂊用氏一
觝	𠂊用氏丶
蜺	虫臼儿
釬	金干
嬭	女一八巾乂乂乂乂
无	一尤
与	一乚一
样	木羊
国	圍王丶
吨	口丿屮
吨	口一屮
户	户
巩	工凡
却	土厶卩
担	扌日一
撑	扌小冖口手
携	扌隹㇕丿
抬	扌厶口
栀	扌𠂆一卩
构	木勹厶
贋	厂亻隹貝
医	匚矢
蝎	虫日勹亡
虮	虫几
咏	口丶水
踪	足宀示
叹	口又
网	冂乂乂
冈	冂乂
岭	山亼卩
岭	山亼龴
复	𠂉日夂
笋	竹尹
偬	亻勿丶心
众	人人人
脚	月土厶卩
胆	月日一
庄	广土
凉	冫亠口小
决	冫㇕大
恒	心二日
潜	氵夫夫日
汹	氵乂凵
袜	衤一木
宫	宀口口
幂	冖日大巾
卺	㇕水一卩
异	巳廾
壜	土日雨二厶
韆	革之西大巳
韆	革之西大卩
苁	艹人人
栅	木冊
虬	虫乚
吕	口口
咤	口宀丿七
罎	午凵日雨二厶
秆	禾干
鼹	臼釆日宀女
隽	隹㇕丿
腭	月口口一丂
腭	月口口丂一
删	冊刂
胶	月亠八乂
鰌	魚八酉
籼	米山
泞	氵宀丁
姗	女冊
耤	耒廿日
耑	山而
苺	艹母
崳	山亼月刂
崳	山亼月巛
譆	言士口䒑口
扰	扌尤
芜	艹一尤
芦	艹户
碱	石戊一口
奋	大田
厩	厂艮旡
邮	由阝
毁	臼工殳
体	亻木一
优	亻尤
犹	犭尤
肮	月亠几
凑	冫丰一大
痒	疒羊
烛	火虫
怜	心亼卩
怜	心亼龴
惊	心亠口小
羡	羊二欠
羡	羊冫欠
洁	氵士口
垦	艮土
竪	臣又立
篱	竹亠乂凵冂厶
胇	月弓刂
灯	火丁
粧	米广土
鑵	金艹口口隹
媮	女亼月刂
媮	女亼月巛
舋	臼冂一口冖且
橱	木厂一口䒑寸
减	冫戊一口
耻	耳止
忾	心气
厨	厂一口䒑寸
蹰	足厂一口䒑寸
凛	冫亠圍口示
奬	爿䏑寸大
搥	扌之丿㠯
薴	艹宀心皿丁
叡	卜冖一八人目又
耡	耒且力
饟	食衣口口甘
欸	厶矢欠
厦	厂頁夂
厮	厂甘廾斤
亲	立木
届	尸由
瑯	王丶艮阝
鶏	爪夫鳥
瘉	疒亼月刂
瘉	疒亼月巛
鱫	魚爪冖心夂
袪	衤土厶
餬	食十口月
煖	火爪一𠂇又
埼	土大丁口
楄	木户冊
殽	乂𠂇月殳
珐	王土厶
徬	行亠八冖方
鉆	金卜口
琎	王之二刂
蹠	足广廿火
腘	月圍王丶
釆	釆
摀	扌烏
碶	石丰刀大
厢	厂木目
厠	厂貝刂
籴	人米
忧	心尤
伕	亻夫
禀	亠圍口示
幵	干干
眞	匕目廾
繈	糸弓厶虫
埜	木木土
疍	足日一
説	言八口儿
詻	言夂口
鼇	士方攵黽
鼇	土方攵黽
鼇	丰力攵黽
嵒	口口口山
餽	食鬼
粏	米大丶
叠	又又又冖且
湣	氵巳七日
俵	亻丰衤
开	一廾
录	彐水
献	十冂半犬
园	圍一兀
杀	乂木
卬	匕卩
寻	彐寸
邓	又阝
茍	卜卜勹口
吓	口下
彔	彑水
瓖	王衣口口甘
挶	扌尸㇕口
菫	艹一口丰
偪	亻一口田
僣	亻夫夫日
沨	氵風
栒	木勹日
鐎	金隹火
萹	艹户冊
嘡	口小冖口土
譔	言巳巳艹廾
殰	一夕士四貝
撦	扌大耂
箄	竹鬼十
鎯	金丶艮阝
餈	二欠食
餈	冫欠食
溇	氵婁
缐	糸白水
触	𠂊用虫
梽	木士心
媭	彡頁女
敩	⺍冖子攵
峃	⺍冖山
栐	木丶水
訢	言斤
勣	丰貝力
拃	扌𠂉匕
櫂	木习习隹
閲	門八口儿
偽	亻爲
鎷	金馬
搾	扌穴𠂉匕
槜	木隹㇕丿
蹾	足亠口子攵
鐏	金八酉寸
顔	立丿彡頁
权	木又
杂	九木
丽	一冂丶冂丶
垯	土之大
币	丿巾
仅	亻又
澛	氵魚日
沟	氵勹厶
灵	彐火
叇	二厶之尹⺍
萚	艹扌又キ
翙	山夕习习
箓	竹彐水
偺	亻夂卜日
鏆	金母貝
浕	氵尸丶冫
媿	女鬼
茧	艹虫
杧	木亡
鰙	魚艹𠂇口
鯎	魚戊㇕
怀	心不
濬	氵卜冖一八目
汈	氵㇕一
塆	土大八弓
摃	扌工貝
蒅	艹氵九木
蟺	虫亠圍口日一
洟	氵大弓
睍	目見
佪	亻圍口
澂	氵山一王攵
彊	弓三田田
﨟	艹月日勹亡
蓢	艹丶艮月
酛	酉一兀
䶮	龍一大
圙	圍八頁圍
蹽	足一火日小
峧	山亠八乂
箠	竹千艹二
儸	亻四糸隹
剉	人人土刂
鳤	魚竹宀㠯
魞	魚人
褎	衣臼禾
濹	氵田土火土
婫	女日匕匕
絺	糸乂𠂇巾
袰	母衣
扺	扌氏
茓	艹穴
㭎	木冂乂
柽	木又土
硔	石艹廾
蹻	足丿大口冂口
啗	口𠂊臼
昙	日二厶
崠	山木日
积	禾口八
敌	舌攵
侚	亻勹日
鈇	金夫
銶	金十⺍丶
魹	魚毛
浬	氵田土
絶	糸𠂊巴
鬶	夫見一口冂八丁
壈	土亠圍口禾
块	土㇕大
毮	扌小丿毛
挘	扌小丿力
薳	艹之土口衤
薭	艹禾鬼十
桛	木上下
橦	木立田土
鶍	日勿鳥
峂	山夂冫
籡	竹扌亼口口人人
䅟	禾厶大彡
劄	竹亼口刂
卽	白匕卩
㑇	亻𠂊彐
鱪	魚日耂
鱛	魚八四日
鱛	魚八田日
匋	勹午凵
鱜	魚乚凵丶艮阝
鱜	魚乚凵艮阝
庼	广匕頁
滧	氵亠八乂攵
襅	衤甲艹二
屝	尸非
嗧	力口亼冊
紬	糸由
嚮	乚凵丶艮阝宀口
嚮	乚凵艮阝宀口
殻	士冖几殳
搆	扌甘冂土
搯	扌爪臼
挌	扌夂口
棊	甘廾木
棡	木冂䒑山
噚	口彐工口寸
瞜	目婁
筴	竹大人人
餔	食甫
餗	食木口
舘	亼十口宀㠯
鑪	金虎田皿
备	夂田
謡	言爪干凵
謡	言爪午凵
詶	言⺍川
訑	言也
痳	疒木木
关	䒑大
忏	心千
汍	氵丸
溈	氵爲
队	阝人
緑	糸彐水
墫	土八酉寸
鶄	丰月鳥
騧	馬咼
駃	馬㇕大
撢	扌西日十
撝	扌爲
㧐	扌又又
鷰	廿口北鳥
懃	艹口丰力心
懃	廿口丰力心
䓬	艹卜日十
䓖	艹穴力
蘗	艹尸口辛木
鶒	木口力鳥
軏	車兀
輗	車臼儿
軨	車亼卩
軨	車亼龴
㰀	木禾丿刀人水
楙	木予丿木
碕	石大丁口
囓	口丰刀止齒
啣	口午止卩
㘎	口門丁耳攵
㘎	口門㇕耳攵
僊	亻西大巳
僊	亻西大卩
㿠	白小兀
儁	亻隹冂凵
鎗	金人户口
貙	豸匚口口口
貍	豸田土
録	金彐水
鐍	金予丿冂儿口
鐍	金予丿冂八口
䏝	月キ龴
鱰	魚四耂
鮸	魚召儿
鮟	魚宀女
譊	言土土土兀
諰	言田心
譅	言刀丶刀丶止止
旛	方𠂉釆田
凅	冫圍十口
㤘	心𠂊彐
鸂	氵爪幺大鳥
宪	宀牛儿
㮣	艮旡木
勦	巛田木力
纁	糸千四二火
婬	女爪工一
婬	女爪丿士
毌	母十
现	王見
个	竹
说	言八口儿
为	爲
没	氵殳
这	之文
对	又寸
发	乚丿又丶
两	一冂人人
项	工頁
专	キ龴
来	木䒑
动	二厶力
长	長
联	耳䒑大
帮	丰阝巾
热	扌丸火
拨	扌乚丿又丶
带	艹丨冖巾
节	艹卩
标	木示
横	木廿由八
龙	龍
页	頁
顾	厂卩頁
车	車
区	匚乂
暂	車斤日
轨	車九
软	車欠
点	卜口火
旧	丨日
齿	齒
别	口力刂
员	口貝
吗	口馬
时	日寸
业	业
当	小彐
电	申
贱	貝一戈
败	貝攵
内	冂人
贩	貝𠂆又
见	見
赔	貝立口
县	且厶
税	禾八口儿
气	气
传	亻キ龴
顺	川頁
们	亻門
伪	亻爲
会	人二厶
领	亼龴頁
从	人人
镇	金十目廾
须	彡頁
钱	金一戈
钻	金卜口
钢	金冂乂
铁	金手丶
铬	金夂口
胀	月長
腻	月弋二貝
独	犭虫
肿	月中
风	風
脱	月八口儿
鱼	魚
条	夂木
乐	𠂆木
争	𠂊尹
鸟	鳥
讲	言二刂
让	言上
调	言用口
齐	齊
诉	言斤丶
设	言殳
该	言亠凵人
变	大八又
装	爿士衣
闻	門耳
闭	門十丿
问	門口
间	門日
门	門
将	爿夕寸
将	爿爪寸
应	广⺍一
疗	疒了
废	广乚丿又丶
类	米大
炼	火七㇕八
总	八口心
单	八甲一
粮	米丶艮
数	婁攵
洒	氵西
滤	氵虎心
测	氵貝刂
学	⺍冖子
汉	氵又
泼	氵乚丿又丶
宽	宀艹見
军	冖車
补	衤卜
审	宀申
实	宀冫大
马	馬
层	尸二厶
颇	皮頁
观	又見
难	又隹
验	馬亼⺍一
买	㇕冫大
骗	馬户冊
张	弓長
阳	阝日
费	弓刂貝
办	力八
阴	阝月
习	习
弹	弓八甲一
随	阝之𠂇月
红	糸工
续	糸十㇕冫大
纯	糸一屮
细	糸田
组	糸且
统	糸亠厶儿
断	米乚斤
编	糸户冊
经	糸㇕丶工
顸	干頁
蚕	一大虫
顶	丁頁
鹉	戈止鳥
垩	亞土
严	一业丿
亚	亞
恶	亞心
画	一由凵
画	一田凵
残	一夕一戈
残	一夕二戈
殒	一夕口貝
歼	一夕千
殓	一夕亼⺍一
殁	一夕殳
殡	一夕宀斤廾
灭	一火
虿	一力虫
迈	之一力
坛	土二厶
墙	土十䒑圍口
盐	土卜皿
韦	㐄
颉	士口頁
埘	土日寸
坝	土貝
趱	走牛儿牛儿貝
进	之二刂
辇	夫夫車
规	夫見
赵	走乂
顽	一兀頁
远	之一兀
趋	走𠂊彐
坟	土文
圹	土广
颊	大䒑頁
夹	大䒑
郏	大䒑阝
壶	士冖业
壳	士冖几
声	士尸
韫	㐄日皿
场	土㇕勿
韬	㐄爪臼
运	之二厶
玮	王㐄
寿	丰寸
焘	丰寸火
耢	耒艹冖力
环	王不
珑	王龍
顼	王頁
琏	王之車
职	耳口八
璎	王貝貝女
责	丰貝
瑶	王爪干凵
瑶	王爪午凵
玑	王几
靓	丰月見
静	丰月𠂊尹
麸	丰夂夫
𬍛	王𠂆木
艳	丰𠂊巴
聪	耳八口心
耧	耒婁
聍	耳宀丁
鬓	長彡宀斤廾
玛	王馬
聂	耳又又
抚	扌一尤
挟	扌大䒑
摄	扌耳又又
挝	扌之寸
捞	扌艹冖力
抴	扌廿乚
拢	扌龍
挞	扌之大
拣	扌七㇕八
抠	扌匚乂
摅	扌虎心
损	扌口貝
挡	扌小彐
摆	扌四土厶
拥	扌用
攒	扌牛儿牛儿貝
捡	扌亼⺍一
抡	扌人匕
抢	扌人卩
摇	扌爪午凵
垫	扌丸土
蛰	扌丸虫
挚	扌丸手
执	扌丸
抛	扌九力
絷	扌丸糸
撸	扌魚日
换	扌𠂊冂大
搀	扌召儿冫
挣	扌𠂊尹
挤	扌齊
过	之寸
扩	扌广
扪	扌門
搁	扌門夂口
掷	扌䒑大阝
搂	扌婁
㧟	扌氵匚
搅	扌⺍冖見
拧	扌宀丁
挥	扌冖車
撺	扌穴中中
护	扌户
摈	扌宀斤廾
扫	扌彐
摊	扌又隹
扬	扌㇕勿
报	扌卩又
掺	扌厶大彡
拟	扌厶人
荚	艹大䒑
苇	艹㐄
苌	艹長
协	十力八
鞯	革艹一亻子
蔷	艹十䒑圍口
茏	艹龍
荙	艹之大
载	十戈車
莲	艹之車
莴	艹咼
颧	艹口口隹頁
𦭜	艹口八
莳	艹日寸
蓝	艹刂𠂉丶皿
黄	廿由八
蓦	艹日大馬
蔂	艹田糸
苘	艹冂口
贳	廿乚貝
颠	十目廾頁
苋	艹見
荞	艹丿大刂
蔹	艹亼⺍一攵
获	艹犭犬
茑	艹鳥
藷	艹言耂
蔼	艹言日勹亡
𬜬	艹門口
蔺	艹門隹
蒋	艹爿夕寸
蒋	艹爿爪寸
丧	土八衤
啬	十䒑圍口
蕲	艹⺍甲一斤
蕲	艹八甲一斤
荡	艹氵㇕勿
苎	艹宀一
茔	艹冖土
莹	艹冖王丶
荣	艹冖木
荤	艹冖車
萤	艹冖虫
营	艹冖口口
营	艹冖口丿口
荥	艹冖水
蓥	艹冖金
荧	艹冖火
劳	艹冖力
萦	艹冖糸
茎	艹㇕丶工
萧	艹尹川八
卖	十㇕冫大
艺	艹乙
荪	艹子小
苏	艹力八
荫	艹阝月
萨	艹阝立丿
蕴	艹糸日皿
药	艹糸勹丶
飘	西示風
杇	木一丂
杇	木丂一
枨	木長
樯	木十䒑圍口
栉	木艹卩
梦	木木夕
颥	雨而頁
桮	木不口
栊	木龍
雳	雨厂力
栋	木七小
栈	木一戈
枢	木匚乂
梿	木之車
梱	木圍木
档	木小彐
贾	西貝
枧	木見
枣	木冂冫
桥	木丿大刂
酰	酉牛儿
霉	雨𠂉母
检	木亼⺍一
枪	木人卩
枫	木風
橹	木魚日
赖	木口𠂊貝
榇	木立木
霁	雨齊
术	木丶
酿	酉丶艮
桩	木广土
榈	木門口口
楼	木婁
槟	木宀斤廾
树	木又寸
棂	木彐火
椭	木阝𠂇月
杨	木㇕勿
厅	厂丁
厉	厂一力
压	厂土丶
硖	石大䒑
砖	石キ龴
夺	大寸
硕	石頁
厌	厂犬
砗	石車
奁	大匚乂
𬒔	石止月
还	之不
碍	石日一寸
厕	厂貝刂
砚	石見
垄	龍土
砻	龍石
詟	龍言
赝	厂亻隹貝
矶	石几
砜	石風
飙	犬犬犬風
袭	龍衣
态	大丶心
矿	石广
牵	大冖牛
码	石馬
历	厂力
础	石屮凵
轩	車干
辆	車一冂人人
辕	車土口衤
贰	弋二貝
转	車キ龴
辄	車耳乚
连	之車
轰	車又又
轧	車乚
辅	車甫
颐	臣頁
尧	戈兀
翘	戈兀习习
轾	車至
卧	臣卜
轳	車卜尸
辑	車口耳
匮	匚中一貝
轵	車口八
轴	車由
东	七小
辊	車日匕匕
辋	車冂䒑亡
盏	一戈皿
轿	車丿大刂
轷	車爪丁
输	車亼月刂
辁	車人王
殴	匚乂殳
轮	車人匕
堑	車斤土
錾	車斤金
鸦	牙鳥
较	車亠八乂
辙	車亠厶月攵
辘	車鹿
辚	車米夕㐄
辖	車宀丰口
轻	車㇕丶工
辗	車尸廿衤
轺	車召
轫	車刀丶
顿	一屮頁
辎	車巛田
蛱	虫大䒑
龉	齒二乂口
龉	齒工㇕口
螨	虫艹一冂人人
螮	虫廿儿冖巾
蛲	虫戈兀
龇	齒止匕
战	卜口戈
蝇	虫黽
蜗	虫咼
卤	卜圍乂
蛳	虫刂一巾
频	止癶頁
虚	虎业
蛊	虫皿
贞	卜貝
蚬	虫見
龄	齒亼龴
赀	止匕貝
蜕	虫八口儿
蝉	虫⺍甲一
蝉	虫八甲一
虑	虎心
蛏	虫又土
颅	卜尸頁
龌	齒尸至
卢	卜尸
蚂	虫馬
虏	虎力
吴	口一大
哑	口亞
贵	中一貝
围	圍㐄
踌	足丰寸
啧	口丰貝
唛	口丰夂
蹑	足耳又又
𠳐	口丰阝
团	圍十丿
蹒	足艹一冂人人
喷	口十艹貝
躏	足艹門隹
呓	口艹乙
嗹	口之車
咙	口龍
哒	口之大
𠮟	口七
跷	足戈兀
践	足一戈
践	足二戈
呕	口匚乂
嘘	口虎业
啮	口齒
虽	口虫
颚	口口一丂頁
圆	圍口貝
骂	口口馬
黾	黽
呗	口貝
啰	口四夕
郧	口貝阝
跃	足丿大
躜	足牛儿牛儿貝
响	口宀口
哗	口亻匕十
囵	圍人匕
呛	口人卩
嗳	口爪冖𠂇又
叽	口几
鹃	口月鳥
噜	口魚日
唤	口𠂊冂大
图	圍夂冫
鸣	口鳥
跻	足齊
踯	足䒑大阝
喽	口婁
咛	口宀丁
蹿	足穴中中
吣	口心
嘱	口尸丿口冂厶
啸	口尹川八
哟	口糸勹丶
题	日一止頁
师	刂一巾
韪	日一止㐄
𬀩	日㐄
畴	田丰寸
颗	田木頁
晒	日西
昽	日龍
辉	小兀冖車
辈	非車
晓	日戈兀
鸭	甲鳥
显	日业
帅	刂巾
𬀪	日見
临	刂𠂉丶口丨
监	刂𠂉丶皿
览	刂𠂉丶見
鉴	刂𠂉丶金
晔	日亻匕十
尘	小土
暧	日爪冖𠂇又
鶗	日一止鳥
旷	日广
邺	业阝
凿	业半凵
尝	小冖二厶
晕	日冖車
赏	小冖口貝
归	刂彐
贤	刂又貝
肾	刂又月
竖	刂又立
紧	刂又糸
畅	申㇕勿
赋	貝戈止
赇	貝十⺍丶
屿	山一乚一
峡	山大䒑
罢	四土厶
帱	巾丰寸
帐	巾長
账	貝長
帻	巾丰貝
财	貝十丿
瞒	目艹一冂人人
巅	山十目廾頁
嵘	山艹冖木
赎	貝十㇕冫大
赙	貝甫寸
颛	山而頁
眬	目龍
贿	貝𠂇月
鸯	冂大鳥
贼	貝戈𠂇
岽	山七小
岖	山匚乂
崭	山車斤
贴	貝卜口
帧	巾卜貝
帜	巾口八
贶	貝口儿
刚	冂乂刂
赐	貝日勿
幞	巾业半大
岿	山刂彐
𪾢	目見
婴	貝貝女
峤	山丿大刂
贝	貝
赌	貝耂
则	貝刂
赂	貝夂口
岚	山風
岁	山夕
睁	目𠂊尹
购	貝勹厶
罚	四言刂
赃	貝广土
赠	貝八四日
赕	貝火火
赚	貝禾禾彐
髅	骨婁
贮	貝宀一
髋	骨宀艹見
髌	骨宀斤廾
峄	山又キ
瞩	目尸丿口冂厶
赆	貝尸丶冫
剀	山巳刂
觊	山巳見
凯	山巳几
岂	山巳
悬	且厶心
丢	丿土厶
筹	竹丰寸
箨	竹扌又キ
穑	禾十䒑圍口
迁	之千
犊	牛十㇕冫大
笼	竹龍
乔	丿大刂
箧	竹匚大䒑
笺	竹一戈
毡	毛卜口
乱	舌乚
鹄	牛口鳥
篮	竹刂𠂉丶皿
笕	竹見
笔	竹毛
签	竹亼⺍一
秃	禾几
頽	禾几頁
颓	禾几頁
称	禾𠂉小
称	禾𠂊小
称	禾竹八
赞	牛儿牛儿貝
选	之牛儿
稳	禾𠂊彐心
鹅	手戈鳥
辞	舌辛
简	竹門日
篓	竹婁
氢	气㇕丶工
箫	竹尹川八
笃	竹馬
笾	竹之力
俩	亻一冂人人
粤	宀米一丂
粤	宀米丂一
侠	亻大䒑
伟	亻㐄
伥	亻長
债	亻丰貝
偾	亻十艹貝
牍	爿十㇕冫大
鸺	亻木鳥
侥	亻戈兀
贷	亻弋貝
舆	臼車廾
躯	身匚乂
侦	亻卜貝
俣	亻口一大
侣	亻口口
侧	亻貝刂
伣	亻見
皑	白山巳
侨	亻丿大刂
赁	亻丿士貝
伤	亻𠂉力
俭	亻亼⺍一
伦	亻人匕
华	亻匕十
倾	亻匕頁
货	亻匕貝
储	亻言耂
侪	亻齊
奥	宀米大
鹪	隹火鳥
偻	亻婁
伫	亻宀一
傧	亻宀斤廾
侬	亻冖衤
傩	亻又隹
亿	亻乙
龛	亼口龍
剑	亼⺍一刂
敛	亼⺍一攵
刽	人二厶刂
饵	食耳
仓	人卩
馕	食一中冖口口甘衤
馍	食艹日大
馓	食廿月攵
饽	食十冖子
弑	乂木弋工
刹	乂木刂
饶	食戈兀
饯	食一戈
彻	行七刀
饨	食一屮
衔	行金
馈	食中一貝
馄	食日匕匕
饪	食丿士
饫	食丿大
饿	食手戈
饰	食𠂉巾
饬	食𠂉力
饷	食宀口
馊	食臼丨又
丛	人人一
耸	人人耳
怂	人人心
爷	八乂卩
饭	食𠂆又
馁	食爪女
饥	食几
馋	食召儿冫
馅	食𠂊臼
饮	食欠
仑	人匕
馏	食卯田
饱	食勹巳
颔	亼㇕口頁
贪	亼㇕貝
伞	人八十
饼	食䒑廾
馐	食羊彐丨
邻	亼卩阝
邻	亼龴阝
馆	食宀㠯
蚀	食虫
饲	食㇕一口
颁	八刀頁
戗	人卩戈
创	人卩刂
贫	八刀貝
饧	食㇕勿
颂	八厶頁
饴	食厶口
钘	金一廾
钉	金丁
铐	金耂丂
𫓯	金土土
铼	金木䒑
锗	金耂
铑	金耂匕
铗	金大䒑
钍	金土
铸	金丰寸
铒	金耳
𬬮	金長
锖	金丰月
钰	金王丶
镊	金耳又又
钳	金甘
𫓹	金甘廾
针	金十
锘	金艹𠂇口
钴	金十口
错	金廿日
质	𠂆十貝
镬	金艹隹又
𫟹	金艹廾
钵	金木一
铺	金甫
𬭊	金木土
镭	金雨田
𬬸	金木丶
锛	金大十艹
钚	金不
铕	金𠂇月
钛	金大丶
镣	金一火日小
𫟼	金之大
钹	金犬㇕
铚	金至
铙	金戈兀
钷	金匚口
𬬩	金弋
铖	金戊㇕
铽	金弋心
链	金之車
钜	金匚コ
铘	金牙阝
钺	金戈乚
钋	金卜
舻	舟卜尸
锃	金口王
铟	金圍大
锢	金圍十口
钟	金中
铝	金口口
锅	金咼
𫓶	金口月
钽	金日一
锂	金田土
钊	金刂
锞	金田木
钿	金田
锁	金小貝
钞	金小丿
销	金小月
锡	金日勿
镤	金业半大
镗	金小冖口土
铛	金小彐
铜	金冂一口
盘	舟皿
钠	金冂人
钡	金貝
舰	舟見
钼	金目
锄	金且力
钎	金千
锇	金手戈
锆	金牛口
锺	金千日土
锸	金千臼
铣	金牛儿
锹	金禾火
锈	金禾㇕丿
锻	金厂三殳
锽	金白王
钏	金川
镍	金自木
锥	金隹
铂	金白
锦	金白巾
镌	金隹㇕丿
铨	金人王
𬬱	金斤
铩	金乂木
锉	金人人土
钤	金亼㇕
铃	金亼龴
舱	舟人卩
锾	金爪一𠂇又
钐	金彡
锨	金斤欠
钣	金𠂆又
钒	金凡
铅	金几口
钥	金月
锋	金夂丰
铭	金夕口
镥	金魚日
铆	金卯
钦	金欠
钓	金勹丶
钧	金勹冫
铮	金𠂊尹
钩	金勹厶
锌	金辛
锫	金立口
镜	金立日儿
铈	金亠巾
铲	金立丿
铱	金衣
镑	金亠八冖方
锒	金丶艮
钫	金方
锎	金門一廾
钭	金冫十
镀	金广廿又
镧	金門木四
锏	金門日
钔	金門
锵	金爿夕寸
锵	金爿爪寸
镰	金广禾禾彐
镁	金羊大
鋭	金八口儿
锐	金八口儿
镨	金立立日
钬	金火
锬	金火火
锑	金弋弓
镂	金婁
铫	金儿⺍
铴	金氵㇕勿
锭	金宀一止
爱	爪冖𠂇又
镩	金穴中中
铋	金弋八
镔	金宀斤廾
释	釆又キ
锯	金尸十口
铍	金皮
镅	金尸目
银	金艮
铌	金尸匕
钗	金又丶
𬬿	金召
锰	金子皿
镄	金弓刂貝
钌	金了
键	金廴彐キ
铷	金女口
锱	金巛田
钕	金女
钆	金乚
𬭁	金母
橥	犭耂木
䏡	月示
肤	月夫
狭	犭大䒑
𦙶	月十口
胧	月龍
胨	月七小
胪	月卜尸
脶	月咼
腽	月日皿
狈	犭貝
猡	犭四夕
犸	犭馬
脸	月亼⺍一
飓	風目廾
飕	風臼丨又
飑	風勹巳
鹏	月月鳥
狰	犭𠂊尹
鸠	九鳥
狱	犭言犬
脐	月齊
脑	月亠乂凵
脏	月广土
犷	犭广
䲢	月半魚
鰧	月半魚
腾	月半馬
狞	犭宀丁
膑	月宀斤廾
脓	月冖衤
胫	月㇕丶工
胁	月力八
猕	犭弓𠂉小
猕	犭弓𠂊小
猕	犭弓竹八
鲠	魚一日乂
鲡	魚一冂丶冂丶
鲆	魚干八
鲑	魚土土
鲒	魚士口
鲮	魚土八夂
鳍	魚耂匕日
䲠	魚丰日
鰆	魚丰日
鲭	魚丰月
鲰	魚耳又
鲯	魚甘廾
鲼	魚十艹貝
鲽	魚廿乚木
鹱	鳥艹隹又
鸨	匕十鳥
鳓	魚革力
鯆	魚甫
鳕	魚雨彐
鲕	魚而
顷	匕頁
鲔	魚𠂇月
鱿	魚尤
鳜	魚厂䒑屮欠
鲅	魚犬丿
鲅	魚犬㇕
鲢	魚之車
处	夂卜
鯱	魚虎
鲇	魚卜口
鲈	魚卜尸
鲴	魚圍十口
鲤	魚田土
鲱	魚非
鳂	魚田衤
鲳	魚日日
鳗	魚日四又
尔	𠂉小
尔	𠂊小
尔	竹八
鲲	魚日匕匕
鲁	魚日
迩	之𠂉小
迩	之𠂊小
迩	之竹八
鳃	魚田心
鲣	魚刂又土
鳎	魚日习习
龟	龜
鲷	魚用口
鲖	魚冂一口
奂	𠂊冂大
鳏	魚四水
岛	鳥山
负	𠂊貝
觯	𠂊用⺍甲一
觯	𠂊用八甲一
稣	魚禾
颖	匕禾頁
鳅	魚禾火
鲧	魚丿糸
鱮	魚臼一乚丨廾
鳇	魚白王
鲋	魚亻寸
鲌	魚白
鲵	魚臼儿
燄	𠂊臼火火
鷈	鳥𠂆虎
鳐	魚爪午凵
凫	鳥几
毕	匕匕十
鲦	魚夂木
𬶋	魚勹口
鲍	魚勹巳
贸	卯貝
鲚	魚齊
鲂	魚方
鲜	魚羊
鳟	魚八酉寸
鳞	魚米夕㐄
鳝	魚羊䒑口
鲩	魚宀一兀
鳊	魚户冊
鸵	鳥宀匕
刍	𠂊彐
鲟	魚彐寸
鴃	鳥㇕大
鲏	魚皮
鲪	魚尹口
雏	𠂊彐隹
皱	𠂊彐皮
邹	𠂊彐阝
鲫	魚艮卩
鱽	魚刀
务	夂力
鸳	夕卩鳥
匀	勹冫
鱾	魚巳
乌	烏
枭	鳥木
鲐	魚厶口
𬣙	言丁一
订	言丁
诃	言丁口
评	言干八
诖	言土土
诗	言土寸
讧	言工
诘	言士口
诸	言耂
诬	言工人人
諸	言耂丶
语	言二乂口
语	言工㇕口
讳	言㐄
诔	言耒
请	言丰月
诹	言耳又
亵	衣扌丸
讨	言寸
计	言十
谋	言甘木
谍	言廿乚木
诺	言艹𠂇口
诂	言十口
谳	言十冂半犬
谎	言艹亡川
读	言十㇕冫大
谌	言甘匚八
𬤇	言西土
谭	言西日十
谏	言木四
斋	文而
诼	言豕
诙	言𠂇火
试	言弋工
诓	言匚王
诫	言戈廾
讶	言牙
𬣡	言一戈
讴	言匚乂
谮	言旡旡日
诚	言戊㇕
讵	言匚コ
讣	言卜
谑	言虎匚一
謼	言虎爪丁
误	言口一大
颤	亠圍口日一頁
识	言口八
赢	亡口月貝凡
诽	言非
刘	文刂
栾	大八木
课	言田木
亩	亠田
蛮	大八虫
谩	言日四又
谡	言田八夂
銮	大八金
诮	言小月
谓	言田月
弯	大八弓
诅	言且
诇	言冂口
𫍣	言冂一口
讪	言山
讷	言冂人
挛	大八手
许	言午
话	言舌
诰	言牛口
诛	言𠂉木
颜	立丿彡頁
诱	言禾㇕丿
诲	言𠂉母
训	言川
谁	言隹
剂	齊刂
谯	言隹火
謏	言臼丨又
谕	言亼月刂
诠	言人王
认	言人
谶	言人人戈非一
诊	言人彡
论	言人匕
义	丶乂
诟	言𠂆一口
䜣	言斤
谣	言爪午凵
诳	言犭王
讥	言几
颃	亠几頁
讽	言風
诡	言𠂊厂卩
谗	言召儿冫
询	言勹日
诣	言匕日
谄	言𠂊臼
谐	言匕匕白
诋	言氏丶
诌	言𠂊彐
鴗	立鳥
鸾	大八鳥
谅	言亠口小
谙	言立日
谚	言立丿彡
议	言丶乂
辩	辛言辛
谛	言亠八冖巾
谤	言亠八冖方
访	言方
斓	文門木四
斓	文門木日
详	言羊
产	立丿
谥	言䒑八皿
谫	言䒑月刂刀
谈	言火火
谜	言之米
谦	言禾禾彐
𬣞	言宀一
諠	言宀二日
诨	言冖車
谴	言之中一㠯
谊	言宀且
诧	言宀丿七
译	言又キ
诀	言㇕大
诐	言皮
诵	言龴用
𬣳	言艮
词	言㇕一口
讯	言乙十
诏	言召
诞	言廴丿止
讱	言刀丶
记	言巳
诒	言厶口
娈	大八女
颏	亠凵人頁
辫	辛糸辛
庑	广一尤
疠	疒一力
闺	門土土
瘗	疒大䒑土
闫	門三
冯	冫馬
痨	疒艹冖力
癞	疒木口𠂊貝
阑	門木四
鹇	門木鳥
头	冫大
庆	广大
库	广車
阉	門大申
庞	广龍
状	爿犬
邝	广阝
阈	門戈口一
冻	冫七小
壮	爿士
阃	門圍木
闸	門甲
阊	門日日
闩	門一
闰	門王
痈	疒用
闲	門木
闽	門虫
訚	門言
闯	門馬
阀	門亻戈
鹰	疒亻隹鳥
瘪	疒自人匕
阋	門臼儿
闪	門人
疮	疒人卩
阌	門爪冖又
疯	疒風
桨	爿夕木
奖	爿夕大
浆	爿夕水
资	冫欠貝
阎	門𠂊臼
癣	疒魚羊
净	冫爪尹
净	冫𠂊尹
闹	門亠巾
闶	門亠几
阂	門亠凵人
痫	疒門木
阅	門八口儿
阐	門⺍甲一
阐	門八甲一
瘘	疒婁
阔	門氵舌
闼	門之大
庐	广户
闷	門心
阕	門癶一大
阚	門㇕耳攵
瘫	疒又隹
疡	疒㇕勿
瘾	疒阝𠂊彐心
疖	疒卩
妆	爿女
兰	䒑二
鲞	半魚
誊	半言
怅	心長
鲝	羊魚
慑	心耳又又
愤	心十艹貝
懒	心木口𠂊貝
娄	婁
恹	心厂犬
烦	火頁
郑	䒑大阝
烧	火戈兀
怄	心匚乂
惭	心車斤
兑	八口儿
兽	八田一口
悭	心刂又土
灿	火山
惧	心目廾
恺	心山巳
养	羊刂
烨	火亻匕十
烃	火㇕丶工
烁	火𠂆木
焕	火𠂊冂大
恼	心亠乂凵
悯	心門文
焖	火門心
悦	心八口儿
惮	心⺍甲一
惮	心八甲一
恽	心冖車
烬	火尸丶冫
忆	心乙
炀	火㇕勿
鹈	弋弓鳥
递	之弋弓
惨	心厶大彡
惯	心母貝
兹	䒑幺幺
举	⺍廾キ
兴	⺍廾
誉	⺍廾言
𬇕	氵一力
洼	氵土土
鸿	氵工鳥
浃	氵大䒑
𣲗	氵㐄
涛	氵丰寸
沣	氵丰
渍	氵丰貝
滟	氵丰𠂊巴
滠	氵耳又又
满	氵艹一冂人人
滞	氵艹丨冖巾
潇	氵艹尹川八
泷	氵龍
沥	氵厂力
浇	氵戈兀
浅	氵一戈
浅	氵二戈
沤	氵匚乂
渐	氵車斤
㳚	氵戈人
汇	氵匚
涟	氵之車
浈	氵卜貝
浊	氵虫
泸	氵卜尸
涠	氵圍㐄
渑	氵黽
涡	氵咼
湿	氵日业
温	氵日皿
溅	氵貝一戈
𬇙	氵貝
滗	氵竹毛
渊	氵川米
潋	氵亼⺍一攵
沦	氵人匕
潴	氵犭耂
鼗	儿⺍士口䒑十又
涤	氵夂木
涣	氵𠂊冂大
渔	氵魚
滦	氵大八木
浐	氵立丿
润	氵門王
澜	氵門木四
瀇	氵广廿一由八
涧	氵門日
沩	氵爲
黉	⺍冖廿由八
浑	氵冖車
觉	⺍冖見
沪	氵户
滨	氵宀斤廾
浓	氵冖衤
泽	氵又キ
浔	氵彐寸
滩	氵又隹
涨	氵弓長
汤	氵㇕勿
涩	氵刀丶止
烫	氵㇕勿火
渗	氵厶大彡
潍	氵糸隹
逦	之一冂丶冂丶
写	冖一乚一
窍	穴工丂
窥	穴夫見
违	之㐄
祷	示丰寸
宝	宀王丶
赛	宀甘八貝
骞	宀甘八馬
宠	宀龍
窃	穴七刀
祯	示卜貝
遗	之中一貝
祸	示咼
褴	衤刂𠂉丶皿
裆	衤小彐
视	示見
袄	衤丿大
鹤	冖隹鳥
裣	衤亼⺍一
穷	穴力
遥	之爪干凵
遥	之爪午凵
宾	宀斤廾
额	宀夂口頁
农	冖衤
祃	示馬
礼	示乚
裤	衤广車
禅	示⺍甲一
禅	示八甲一
迳	之㇕丶工
迟	之尸丶
逊	之子小
边	之力
辽	之了
骊	馬一冂丶冂丶
颈	㇕丶工頁
巯	㇕丶工亠厶川
劲	㇕丶工力
𬴃	馬丰石
骤	馬耳又亻
怼	又寸心
骐	馬甘廾
剧	尸十口刂
骑	馬大丁口
驮	馬大
戏	又戈
驱	馬匚乂
骃	馬圍大
驶	馬口乂
𬴂	馬非
骒	馬田木
剥	彐水刂
骡	馬田糸
驵	馬且
𬳶	馬冂口
驷	馬四
骄	馬丿大刂
属	尸丿口冂厶
驯	馬川
骓	馬隹
肃	尹川八
骅	馬亻匕十
骢	馬囟夂心
驳	馬乂乂
屦	尸行婁
驹	馬勹口
骆	馬夂口
欢	又欠
骝	馬卯田
鸡	又鳥
驻	馬丶王
骍	馬辛
骧	馬衣口口甘
昼	尸丶日一
𫘜	馬文
尽	尸丶冫
骇	馬亠凵人
骥	馬北田艹廾
骈	馬䒑廾
屡	尸婁
驴	馬户
驼	馬宀匕
骟	馬户习习
恳	艮心
驿	馬又キ
预	予頁
艰	又艮
驭	馬又
骉	馬馬馬
骣	馬尸子子子
驰	馬也
劝	又力
骖	馬厶大彡
骀	馬厶口
骏	馬厶八夂
卫	卩一
际	阝示
陕	阝大䒑
陆	阝キ凵
陇	阝龍
陏	阝𠂇月
阵	阝車
陈	阝七小
贺	力口貝
驾	力口馬
陧	阝日土
孙	子小
隄	阝日一止
坠	阝人土
阶	阝亻八
弥	弓𠂉小
弥	弓𠂊小
弥	弓竹八
隐	阝𠂊彐心
飞	乙冫
导	巳寸
𠙶	了凵
纡	糸丁一
妩	女一尤
娅	女亞
结	糸士口
绪	糸耂
绫	糸土八夂
纬	糸㐄
纭	糸二厶
绩	糸丰貝
𬘬	糸丰月
绑	糸丰阝
纣	糸寸
绀	糸甘
缂	糸革
绁	糸廿乚
缚	糸甫寸
𬘭	糸木木
缃	糸木目
绔	糸大一丂
绔	糸大丂一
叁	厶大三
缛	糸辰寸
缅	糸頁圍
参	厶大彡
缄	糸戊一口
绖	糸至
绕	糸戈兀
线	糸一戈
妪	女匚乂
练	糸七㇕八
绰	糸卜日十
娱	女口一大
缉	糸口耳
𬘡	糸圍大
绳	糸黽
娲	女咼
织	糸口八
绢	糸口月
绯	糸非
缦	糸日四又
纱	糸小丿
绡	糸小月
缇	糸日一止
缧	糸田糸
绸	糸用口
䌹	糸冂口
絅	糸冂口
纲	糸冂乂
缨	糸貝貝女
纳	糸冂人
纴	糸丿士
纤	糸千
缵	糸牛儿牛儿貝
妫	女爲
妈	女馬
绣	糸禾㇕丿
缎	糸厂三殳
𬘓	糸川
维	糸隹
绵	糸白巾
缴	糸白方攵
给	糸亼口
绘	糸人二厶
绗	糸行
纵	糸人人
纶	糸人匕
纷	糸八刀
缓	糸爪一𠂇又
绥	糸爪女
绷	糸月月
纨	糸丸
绦	糸夂木
纸	糸氏
绺	糸夂卜口
络	糸夂口
绚	糸勹日
约	糸勹丶
终	糸夂冫
绉	糸𠂊彐
绝	糸𠂊巴
纹	糸文
纺	糸方
娴	女門木
纩	糸广
缠	糸广田土
绊	糸半
婵	女⺍甲一
婵	女八甲一
缯	糸八四日
缮	糸羊䒑口
继	糸米乚
纻	糸宀一
综	糸宀示
绽	糸宀一止
婶	女宀申
缩	糸宀亻一白
缝	糸之夂丰
绾	糸宀㠯
妇	女彐
纽	糸彐丨
绿	糸彐水
纾	糸予
纼	糸弓丨
绍	糸召
贯	母貝
级	糸𠂊又
绋	糸弓刂
纫	糸刀丶
纪	糸巳
丝	糸糸
缘	糸彑豕
纠	糸凵
绐	糸厶口
缫	糸巛田木
乡	乚凵
飨	乚凵食
芈	卜卜キ
鹝	一口冂八丁鳥
戬	一业日戈
鹂	一冂丶冂丶鳥
郦	一冂丶冂丶阝
䴓	一巾鳥
殚	一夕⺍甲一
殚	一夕八甲一
䴕	一夕刂鳥
鴷	一夕刂鳥
殀	一夕丿大
殇	一夕𠂉㇕勿
趸	一力足
劢	一力力
欤	一乚一欠
𤭯	瓦白水
垭	土亞
叆	二厶爪冖𠂇又
福	示一口田
神	示申
赉	木䒑貝
鼋	一兀黽
祥	示羊
𫭼	土艹冖力
㙘	土西女
埯	土大申
坜	土厂力
𫭟	土匚乂
贡	工貝
觋	工人人見
鹀	工人人鳥
垆	土卜尸
韨	㐄犬丿
韨	㐄犬㇕
韧	㐄刀丶
击	キ凵
埙	土口貝
埚	土咼
鼕	士口䒑十又夂冫
垱	土小彐
垲	土山巳
都	耂丶阝
赪	土火卜貝
𫭢	土人匕
坵	土丘
坞	土烏
垴	土亠乂凵
𡐓	土广尹⺍
𫮃	土⺍甲一
𫮃	土八甲一
𪣻	土婁
壸	士冖亞
毂	士冖車殳
𡎚	土户冊
悫	士冖几心
㙍	土又又又又
𪤗	土习习人彡
玙	王一乚一
玨	王王
聩	耳中一貝
𤩽	王十冂半犬
𫞩	王艹一冂人人
颞	耳又又頁
㻬	王雨一丂
㻬	王雨丂一
麺	丰夂頁圍
𪟝	丰貝力
赘	丰力攵貝
鳌	丰力攵魚
骜	丰力攵馬
䴖	丰月鳥
麦	丰夂
麹	丰夂勹米
䂮	丰刀石
㛃	丰刀女
琐	王小貝
珰	王小彐
瓒	王牛儿牛儿貝
瑽	王行人人止
玱	王人卩
瑷	王爪冖𠂇又
琼	王亠口小
𤧛	王亠八冖巾
駻	馬日干
騠	馬日一止
騝	馬廴彐キ
駎	馬由
騪	馬臼丨又
駩	馬人王
騚	馬䒑月刂
𤫉	王言火火又
駶	馬尸㇕口
騃	馬厶矢
珲	王冖車
𬍤	王彐寸
玚	王㇕勿
擣	扌士㇕工一口寸
撷	扌士口頁
撵	扌夫夫車
抟	扌キ龴
搟	扌車干
挠	扌戈兀
掳	扌虎力
掴	扌圍王丶
揽	扌刂𠂉丶見
撄	扌貝貝女
揿	扌金欠
贽	扌丸貝
鸷	扌丸鳥
势	扌丸力
捣	扌鳥山
拦	扌䒑二
掸	扌⺍甲一
掸	扌八甲一
㧑	扌爲
擞	扌婁攵
择	扌又キ
挦	扌彐寸
掼	扌母貝
觐	廿口丰見
荆	艹一廾刂
鹊	廿日鳥
𬟁	艹一口冂八丁鳥
勚	廿乚貝力
颟	艹一冂人人頁
𬜯	艹一冂人人
䢼	艹廾阝
觏	甘冂土見
莱	艹木䒑
韩	十日十㐄
贲	十艹貝
觌	十㇕冫大見
鸪	十口鳥
鹕	十口月鳥
赍	十人人冖貝
𫠆	十又頁
鳷	十又鳥
𨙸	十又阝
鹁	十冖子鳥
鞒	革丿大刂
鞑	革之大
鞲	革甘冂土
䓫	艹大丁口
苈	艹厂力
荛	艹戈兀
蒇	艹戊貝
𬞟	艹止癶頁
蒉	艹中一貝
鹳	艹口口隹鳥
鹋	艹田鳥
萝	艹四夕
蘖	艹丿㠯辛木
莶	艹亼⺍一
荟	艹人二厶
苍	艹人卩
莸	艹犭尤
蓟	艹魚刂
荜	艹匕匕十
藓	艹魚羊
蓠	艹亠乂凵冂厶
荠	艹齊
𫇭	艹爲
蒌	艹婁
薮	艹婁攵
蕰	艹氵日皿
䓨	艹冖午凵
鹲	艹冖一豕鳥
荦	艹冖牛
莺	艹冖鳥
茕	艹冖乙十
荨	艹彐寸
蓣	艹予頁
荩	艹尸丶冫
荬	艹㇕冫大
䓛	艹尸屮凵
𦰡	艹刀二阝
荭	艹糸工
荮	艹糸寸
莼	艹糸丿屮
莼	艹糸一屮
芗	艹乚凵
桠	木亞
梾	木木䒑
𬷕	甫鳥
𬂩	木大䒑
㭕	木土厶
梼	木丰寸
酝	酉二厶
醆	酉戈戈
酽	酉一业丿
酾	酉一冂丶冂丶
𬪩	酉冖衤
酦	酉乚丿又丶
椟	木十㇕冫大
槚	木西貝
枥	木厂力
桡	木戈兀
桢	木卜貝
栌	木卜尸
𣗋	木小冖口儿
榅	木日皿
輮	車予丿木
榄	木刂𠂉丶見
槛	木刂𠂉丶皿
軿	車䒑廾
樱	木貝貝女
椤	木四夕
桤	木山巳
欅	木臼一乚丨廾手
桦	木亻匕十
桧	木人二厶
麨	木人人夂小丿
枞	木人人
𬃊	木𠂆十貝
栎	木𠂆木
槠	木言耂
檩	木亠圍口示
栏	木䒑二
棁	木八口儿
霭	雨言日勹亡
鹴	雨木目鳥
榉	木⺍廾キ
雾	雨夂力
杩	木馬
橼	木糸彑豕
碛	石丰貝
鹩	一火日小鳥
鹌	大申鳥
𥕢	石一曲日
砺	石厂一力
黡	厂犬四土火
黡	厂犬田土火
厍	厂車
靥	厂犬頁圍
䃎	石大夕夕
厣	厂犬甲
魇	厂犬鬼
餍	厂犬食
励	厂一力力
硗	石戈兀
𥔲	石口口一丂
𥔲	石口口丂一
𥖨	石口口口木
𬒗	石刂𠂉丶見
鸸	而鳥
硙	石山巳
聋	龍耳
龚	龍艹廾
硚	石丿大刂
矾	石凡
豮	豕十艹貝
砾	石𠂆木
尴	尤刂𠂉丶皿
䃅	石⺍甲一
䃅	石八甲一
硁	石㇕丶工
砀	石㇕勿
碜	石厶大彡
赜	臣丰貝
鸫	七小鳥
辏	車丰一大
轲	車丁口
轱	車十口
轪	車大
𫐄	車兀
𫟦	車之八豕
轭	車厂卩
轼	車弋工
辌	車亠口小
辐	車一口田
𨐈	車小兀
辒	車日皿
𫐓	車予丿木
轶	車手丶
𫐐	車臼儿
轸	車人彡
斩	車斤
椠	車斤木
辀	車舟
𬨂	車氏
辂	車夂口
轹	車𠂆木
𬨎	車八酉
辍	車又又又又
匦	匚車九
𬌗	牙亼口
𬸘	匚日女鳥
戋	一戈
刬	一戈刂
欧	匚乂欠
鸥	匚乂鳥
瓯	匚乂瓦
鸢	弋鳥
虾	虫下
觇	卜口見
鹾	卜圍乂羊工
鸬	卜尸鳥
蟏	虫艹尹川八
蝾	虫艹冖木
䗖	虫艹丨冖巾
蛎	虫厂一力
戯	虎业戈
戯	虎丘戈
觑	虎业見
𬟽	虫七小
颦	止癶頁鬼十
𫚖	止匕魚
蝈	虫圍王丶
䗴	虫竹廴工一
䗴	虫竹廴丿士
䗴	虫竹廴亻土
䗛	虫亻丨夂月
䗛	虫亻丨攵月
𬺈	齒大丁口
龋	齒丿口冂厶
龊	齒足
龃	齒且
龁	齒𠂉乙
𫠜	齒臼儿
𬹼	齒亻八
龂	齒斤
龀	齒匕
龅	齒勹巳
𬺓	齒木木足
龈	齒艮
龆	齒召
蛴	虫齊
蚁	虫丶乂
蝼	虫婁
呒	口一尤
𫫇	口亞心
鸮	口丂鳥
唝	口工貝
嗫	口耳又又
圞	圍言糸糸木
囌	口艹魚禾
唠	口艹冖力
呖	口厂力
哓	口戈兀
啭	口車キ龴
踬	足𠂆十貝
跶	足之大
鹭	足夂口鳥
蹧	足一曲日
跹	足之千
跄	足人卩
跸	足匕匕十
跞	足𠂆木
𧿹	足母
嚣	口口頁口口
鼍	口口田一黽
鹗	口口一丂鳥
唢	口小貝
𫑡	黽阝
嘤	口貝貝女
呐	口冂人
呙	咼
剐	咼刂
哕	口山夕
勋	口貝力
哙	口人二厶
㕮	口八乂
哔	口匕匕十
呜	口烏
啴	口⺍甲一
啴	口八甲一
咷	口儿⺍
哝	口冖衤
咝	口糸
坚	刂又土
𬱖	由頁
櫐	田田田木
颙	日冂厶頁
䣘	小冖口土阝
㬊	日爪一𠂇又
鹍	日匕匕鳥
鹖	日勹亡鳥
颢	日亠口小頁
㬚	日亠厶月攵
㫰	日丶艮
鳖	巾⺍攵魚
晖	日冖車
旸	日㇕勿
㬎	日幺幺火
睐	目木䒑
䎃	冂土习习
䴗	目犬鳥
鶪	目犬鳥
眍	目匚乂
帏	巾㐄
帼	巾圍王丶
羁	四革馬
黪	四土火厶大彡
黪	田土火厶大彡
罦	四爪子
鹮	四一口衤鳥
罗	四夕
逻	之四夕
黩	四土火十㇕冫大
黩	田土火十㇕冫大
罴	四土厶火
㠓	山艹冖一豕
㟃	山㇕一口
崃	山木䒑
崄	山亼⺍一
𪨶	山大車
𪩘	山十冂半犬
𫵷	山厂力
峣	山戈兀
㠇	山亠口小尤
𪨰	山曲
岗	山冂乂
岘	山見
𨟠	目目隹阝
嵚	山金欠
刿	山夕刂
峥	山𠂊尹
嵝	山婁
𫶇	山艹丨冖巾
崂	山艹冖力
𫖮	山巳頁
赒	貝用口
睑	目亼⺍一
罂	貝貝午凵
赈	貝辰
赗	貝冖二目
赑	貝貝貝
贬	貝丿之
赊	貝人示
赡	貝𠂊厂八言
贻	貝厶口
赅	貝亠凵人
鹦	貝貝女鳥
觃	見子
䁖	目婁
鹘	骨鳥
矫	矢丿大刂
鳘	𠂉母攵魚
缾	午凵䒑廾
牺	牛西
𬕂	竹工貝
酂	牛儿牛儿貝阝
颋	廴亻土頁
箦	竹丰貝
稆	禾口口
稆	禾口丿口
秽	禾山夕
籁	竹木口𠂊貝
鹙	禾火鳥
秾	禾冖衤
𥝱	禾予
岙	丿大山
氇	毛魚日
鸹	舌鳥
篑	竹中一貝
筼	竹口貝
筛	竹刂一巾
筜	竹小彐
箩	竹四夕
衅	丿皿半
篯	竹金一戈
筚	竹匕匕十
筝	竹𠂊尹
箪	竹⺍甲一
箪	竹八甲一
簖	竹米乚斤
氩	气亞
氲	气日皿
俨	亻一业丿
俪	亻一冂丶冂丶
俫	亻木䒑
俦	亻丰寸
伛	亻匚乂
雠	隹言隹
鹎	鬼十鳥
魉	鬼一冂人人
囱	囟夂
偿	亻小冖二厶
傥	亻小冖口儿
侩	亻人二厶
伧	亻人卩
㑊	亻大八
仪	亻丶乂
𫢸	亻⺍甲一
𫢸	亻八甲一
佥	亼⺍一
㙦	亼木冫十土
颌	亼口頁
鸽	亼口鳥
觎	亼月刂見
鸰	亼龴鳥
鸧	人卩鳥
郐	人二厶阝
徕	行木䒑
惩	行一止心
衚	行十口月
鸻	行鳥
径	行㇕丶工
鹆	八人口鳥
饸	食亼口
馔	食巳巳艹廾
𫗧	食木口
馑	食廿口丰
饘	食亠圍口日一
馇	食木日一
𫗴	食亠圍口日一
馃	食田木
馉	食骨
馒	食日四又
饩	食气
餭	食白王
饺	食亠八乂
饹	食夂口
饻	食衣
馌	食土厶皿
饳	食屮凵
鹟	八厶习习鳥
铏	金一廾刂
钲	金一止
钙	金下乚
镉	金一口冂八丁
𫓧	金夫
𬭳	金士口䒑口
铻	金二乂口
铻	金工㇕口
𬭬	金丰丰彐
锲	金丰刀大
颀	斤頁
䴘	𠂆虎鳥
慇	𠂆彐㇕殳心
𨱇	金十⺍丶
鎝	金艹亼口
𨱏	金艹亼口
䦃	金艹耂
镆	金艹日大
锚	金艹田
𨱑	金廿由八
锳	金艹冂大
铹	金艹冖力
镖	金西示
镈	金甫寸
镡	金西日十
𬸪	釆田鳥
锜	金大丁口
镢	金厂䒑屮欠
钝	金一屮
𬬻	金卜尸
锷	金口口一丂
铞	金口巾
锝	金日一寸
铀	金由
钾	金甲
𬬹	金申
镋	金小冖口儿
镘	金日四又
𬭯	金巾⺍攵
锟	金日匕匕
锶	金田心
铿	金刂又土
𬭶	金四土火
𬭶	金田土火
镮	金四一口衤
铡	金貝刂
镚	金山月月
镯	金四勹虫
锣	金四夕
铠	金山巳
铤	金廴亻土
铥	金丿土厶
锤	金千艹二
铢	金𠂉木
釳	金𠂉乙
𬭤	金亻コ矢
铧	金亻匕十
锼	金臼丨又
铪	金亼口
镎	金亼口手
鏦	金行人人止
鍮	金亼月刂
鍮	金亼月巛
𬬭	金人匕
𬭩	金八厶习习
锊	金爪寸
锧	金𠂆十貝
𫔍	金釆田
䝙	豸匚乂
铄	金𠂆木
锪	金勿心
锴	金匕匕白
镵	金召匕匕召儿丶
铯	金𠂊巴
镏	金卯田
钨	金烏
镶	金衣口口甘
镐	金亠口冂口
锿	金衣口
𬭚	金亠口子
镱	金立日心
镞	金方𠂉矢
铰	金亠八乂
钪	金亠几
镝	金亠八冂十口
镦	金亠口子攵
锍	金亠厶川
铳	金亠厶儿
铉	金亠幺
镳	金鹿火
镛	金广尹用
𨱔	金八酉寸
镒	金䒑八皿
𬭸	金米夕㐄
锩	金半卩
镃	金䒑幺幺
觅	爪見
𬭛	金氵皮
鹞	金午凵鳥
镓	金宀豕
𬭎	金宀𠂇厶
镕	金穴人口
镲	金宀䏑又示
铊	金宀匕
𬭼	金之八豕
铵	金宀女
铎	金又キ
钮	金彐丨
镫	金癶一口䒑
𫔎	金予丿冂八口
锓	金彐冖又
锔	金尸㇕口
锕	金阝丁口
钇	金乙
钯	金巴
镪	金弓口虫
钖	金㇕勿
镠	金习习人彡
鸼	舟鳥
舣	舟丶乂
镴	金巛圍乂巛
䥽	金乚丿又丶
飐	風卜口
飔	風田心
凤	几又
飗	風卯田
飏	風㇕勿
腼	月頁圍
颾	風又冫虫
颾	風又丶虫
䐃	月圍禾
狮	犭刂一巾
猪	犭耂丶
猃	犭亼⺍一
狯	犭人二厶
𫛭	犭王鳥
獱	犭宀一癶貝
㺄	犭亼月刂
㺄	犭亼月巛
狝	犭𠂉小
狝	犭𠂊小
狝	犭竹八
獭	犭木口𠂊貝
臜	月牛儿牛儿貝
𬸚	犭言犬鳥
狲	犭子小
脍	月人二厶
䏲	月弋弓
𦝼	月婁
肠	月㇕勿
鲾	魚一口田
𬶮	魚士口䒑口
𩸽	魚艹亻匕
鳠	魚艹隹又
𩺊	魚艹亡川
鳔	魚西示
𬶟	魚木口刂
𬶠	魚木四
𬱟	𠂊厂卩頁
鳡	魚戊一口心
鹠	卯田鳥
鸱	氏丶鳥
鲀	魚一屮
鳄	魚口口一丂
鳀	魚日一止
𫚕	魚刂一巾
鲿	魚小冖二厶
玺	𠂉小王丶
玺	𠂊小王丶
玺	竹八王丶
鲥	魚日寸
鲉	魚由
鳢	魚曲一口䒑
鳁	魚日皿
鲗	魚貝刂
觞	𠂊用𠂉㇕勿
鰤	魚丿㠯一巾
鲊	魚𠂉匕
鳈	魚白水
鹐	𠂊臼鳥
鲙	魚人二厶
鲘	魚𠂆一口
䲟	魚臼卩
𬶭	魚䏑又示
𬶏	魚𠂊厂卩
𩾃	魚召儿
颍	匕水頁
毙	匕匕一夕匕
颎	匕火頁
鲸	魚亠口小
鳣	魚亠圍口日一
惫	夂田心
鲛	魚亠八乂
鳑	魚亠八冖方
鳉	魚爿夕寸
鳉	魚爿䏑寸
鳉	魚爿爪寸
鱇	魚广尹⺍
𩾌	魚广尹⺍
鳙	魚广尹用
鳒	魚禾禾彐
𬶐	魚儿⺍
𬶍	魚宀匕
𩽾	魚宀女
鳚	魚尸示寸
鲬	魚龴用
鲃	魚巴
鸲	勹口鳥
鲺	魚乙丿虫
鳛	魚习习白
邬	烏阝
鲹	魚厶大彡
鲻	魚巛田
𫚭	魚巛圍乂巛
袅	鳥衣
讦	言干
证	言一止
谨	言廿口丰
谟	言艹日大
𬤝	言一日厶心
𫍯	言戊一口
鹯	亠圍口日一鳥
谔	言口口一丂
鹫	亠口小尤鳥
亸	亠口子⺍甲一
亸	亠口子八甲一
鹑	亠口子鳥
𬤊	言日一止
谠	言小冖口儿
峦	大八山
脔	大八䏑
谒	言日勹亡
恋	大八心
𠅤	亠田心
孪	大八子
𫍽	言四一口衤
诈	言𠂉匕
诜	言牛儿
讫	言𠂉乙
诿	言禾女
谢	言身寸
谀	言臼人
讹	言亻匕
𫍲	言臼丨又
赟	文戈止貝
𨭉	文戈止金
齑	齊非一
䴔	亠八乂鳥
鵁	亠八乂鳥
鳼	文鳥
谂	言亼㇕心
讻	言乂凵
兖	亠八厶儿
衮	衣八厶
讼	言八厶
谖	言爪一𠂇又
谵	言𠂊厂八言
诤	言𠂊尹
谆	言亠口子
谇	言亠人人十
谪	言亠八冂十口
谰	言門木四
赣	立日十夂工貝
竞	立口儿
谱	言立立日
戆	立日十夂工貝心
産	立丿生
彦	立丿彡
飒	立風
𦒍	立田土习习
谝	言户冊
谧	言弋八皿
谞	言足月
谲	言予丿冂八口
㮾	丶艮月木
𬸦	方𠂉矢鳥
谬	言习习人彡
诩	言习习
诎	言屮凵
盗	二欠皿
盗	冫欠皿
癫	疒十目廾頁
廪	广亠圍口示
庙	广由
麽	广木木丿厶
麽	广十儿十儿丿厶
庂	广人
赓	广彐人貝
鹒	广彐人鳥
𫷷	广金欠
䗪	广廿火虫
鹧	广廿火鳥
疬	疒厂力
廱	广巛口巴隹
疟	疒匚一
酱	爿夕酉
瘻	疒婁
阇	門耂
闱	門㐄
𬮱	門西土
阒	門目犬
闳	門𠂇厶
闾	門口口
阄	門龜
阗	門十目廾
闿	門山巳
瘿	疒貝貝女
𫔶	門自木
阏	門方人冫
阁	門夂口
阍	門氏日
闵	門文
阆	門丶艮
阘	門日习习
阖	門土厶皿
阙	門䒑屮欠
疭	疒人人
痪	疒𠂊冂大
瘅	疒⺍甲一
瘅	疒八甲一
痉	疒㇕丶工
瘆	疒厶大彡
怃	心一尤
鹢	䒑八皿鳥
鹣	禾禾彐鳥
鹚	䒑幺幺鳥
㥄	心土儿夂
㥄	心土八夂
恸	心二厶力
盖	羊皿
羟	羊㇕丶工
冁	⺍甲一尸廿衤
冁	八甲一尸廿衤
郸	⺍甲一阝
郸	八甲一阝
䎖	八四日习习
䎖	八田日习习
粝	米厂一力
粪	米艹廾
糁	米厶大彡
𥻗	米木日一
惬	心匚大䒑
愦	心中一貝
愠	心日皿
恻	心貝刂
炜	火㐄
烩	火人二厶
㸌	火雨隹
𬉼	火匚乂
炖	火丿屮
炖	火一屮
㸆	火牛口非
炽	火口八
煴	火日皿
㶲	火用
炝	火人卩
烂	火䒑二
𬊤	火⺍甲一
𬊤	火八甲一
炉	火户
𬊈	火彐寸
怆	心人卩
忷	心乂凵
恟	心勹乂凵
懔	心亠圍口示
怿	心又キ
𣲘	氵一尤
涞	氵木䒑
沍	氵一彑
喾	⺍冖牛口
𬒈	⺍冖石
鲎	⺍冖魚
𣸣	氵十艹貝
懑	氵艹一冂人人心
渎	氵十㇕冫大
滢	氵艹冖王丶
溁	氵艹冖木
涝	氵艹冖力
潆	氵艹冖糸
漤	氵木木女
濑	氵木口𠂊貝
㵐	氵厂䒑屮欠
濒	氵止癶頁
溃	氵中一貝
𬇹	氵圍王丶
浉	氵刂一巾
灏	氵日亠口小頁
滥	氵刂𠂉丶皿
鲨	氵小丿魚
浍	氵人二厶
㽏	氵亼口甘
溆	氵亼木又
㳇	氵八乂
鹡	⺍人月鳥
沧	氵人卩
𫖯	儿⺍頁
泺	氵𠂆木
㴔	氵𠂊彐心
浏	氵文刂
浒	氵言午
济	氵齊
湾	氵大八弓
㳘	氵亠厶儿
瀁	氵羊丶艮
泻	氵冖一乚一
泾	氵㇕丶工
滪	氵予頁
渌	氵彐水
𬍡	氵㇕勿王丶
塚	土冖豕
鸋	宀心皿丁鳥
𬸣	宀甘八鳥
寝	宀爿彐冖又
窜	穴中中
窝	穴咼
窎	穴鳥
窦	穴十㇕冫大
窭	穴婁
祎	示㐄
祢	示𠂉小
祢	示𠂊小
祢	示竹八
禄	示彐水
袆	衤㐄
𫌀	衤丰貝
衬	衤寸
襕	衤門木四
裢	衤之車
裥	衤門日
褛	衤婁
裈	衤冖車
袯	衤乚丿又丶
皲	冖車皮
郓	冖車阝
鸩	冖儿鳥
𬩽	彐寸阝
彟	彐寸艹隹又
鹔	尹川八鳥
彞	彐米糸廾
鷴	門木鳥
閍	門方
骠	馬西示
骦	馬雨木目
𬳵	馬不一
𫘪	馬厂白小
骁	馬戈兀
𫘨	馬日一止
骋	馬由丂
驲	馬日
𫖳	尹口頁
屩	尸行丿大口冂口
屃	尸貝
鹛	尸目鳥
𬳽	馬牛儿
鸤	尸鳥
䴙	尸口辛鳥
鷿	尸口辛鳥
驸	馬亻寸
𬳿	馬亼木
𬶨	艮旡魚
𫘬	馬爪幺大
𫘦	馬勹午凵
驺	馬𠂊彐
刭	㇕丶工刂
颡	又又又木頁
鹬	予丿冂八口鳥
鹜	予丿攵鳥
骛	予丿攵馬
双	又又
𫠊	馬亠幺
𬴊	馬米夕㐄
骙	馬癶一大
𫘝	馬㇕大
𫘧	馬彐水
骕	馬尹川八
骚	馬又丶虫
骎	馬彐冖又
书	㇕㇕丨丶
堕	阝𠂇月土
骘	阝止癶馬
𬯎	阝中一貝
陨	阝口貝
𬮿	阝山巳
𨺙	阝臼儿
险	阝亼⺍一
𬯀	阝齊
鹨	习习人彡鳥
翚	习习冖車
陉	阝㇕丶工
𫸩	弓匚乂
缙	糸一业日
绠	糸一日乂
缬	糸士口頁
缰	糸三田田
缜	糸十目廾
缥	糸西示
縳	糸一日厶寸
𦈡	糸雨而
绮	糸大丁口
缭	糸一火日小
绂	糸犬㇕
纮	糸𠂇厶
绒	糸戈𠂇
辔	車糸糸口
粜	屮凵米
䢺	屮凵阝
缲	糸口口口木
缱	糸之中一㠯
绅	糸申
绱	糸小冂口
缊	糸日皿
缆	糸刂𠂉丶見
绲	糸日匕匕
缌	糸田心
缳	糸四一口衤
缈	糸目小丿
𬙊	糸四土火土
𫄸	糸千四二火
娇	女丿大刂
嫒	女爪冖𠂇又
娆	女戈兀
𫄧	糸廴丿止
嫱	女十䒑圍口
媪	女日皿
㛹	女亻一日乂
婳	女一由凵
婳	女一田凵
姹	女宀丿七
嬷	女广木木丿厶
嬷	女广十儿十儿丿厶
㚷	女人小
嫔	女宀斤廾
嬝	女鳥衣
𫰛	女㇕丶工
㛚	女龴用
驽	女又馬
纥	糸𠂉乙
缒	糸之丿㠯
缑	糸亻コ矢
𫄨	糸乂𠂇巾
绤	糸八人口
绶	糸爪冖又
绹	糸勹午凵
绛	糸夂㐄
纰	糸匕匕
𬙋	糸衣口口甘
𨚕	厶廾阝
𫟅	糸亠口小
缟	糸亠口冂口
𬘯	糸亠口子
缞	糸衣口一
𫄷	糸立日心
缡	糸亠乂凵冂厶
绞	糸亠八乂
毵	厶大彡毛
缔	糸亠八冖巾
繸	糸之八豕
缢	糸䒑八皿
缣	糸禾禾彐
绻	糸半卩
绨	糸弋弓
缕	糸婁
𬘫	糸宀一兀
𬙂	糸宀一由八
缤	糸宀斤廾
𬘘	糸冖儿
绎	糸又キ
缀	糸又又又又
缗	糸巳七日
𬘩	糸廴亻土
缪	糸习习人彡
鸶	糸糸鳥
缁	糸巛田
绌	糸屮凵
𩹬	魚木十口
𥈴	目虎匚一
𣴛	氵戈𠂇
𡄍	口竹馬
鉳	金北
𪷉	氵糸田
𢠩	心广木木
𢠩	心广十儿十儿
𢸛	扌言用口
𢃱	巾甘木
揇	扌十冂半
𪞺	屮凵爪子乚
𩲵	鬼生
𦁹	糸亠亻夂丶
𧓇	虫尸艹廾殳
𠴐	口心彐丨
𱽐	艹几二
㨳	扌宀大丁口
𥴢	竹禾隹
𠿁	口甘廾欠
𡔔	土艹門木四
𡔔	土艹門木日
𦄇	糸氵日土
𡐙	土行日一寸
𢲔	扌王刂王
𧚟	衤尸毛
𫕰	雨月丰キ
𢯡	扌亠厶月
𪧸	土寸亻士
𨆝	足亼四日
䱛	魚戈口一
𬹓	廿由八亞心
𪆦	彡頁鳥
𧍴	虫木四
𪟀	刀方
𬦪	足召
𠍤	亻艹十冖子
扙	扌一乂
𤅜	氵西示風
𠞺	一夕刂文口
㔧	虎田皿力
𪄨	口小月鳥
𥓵	石广氏一
𥓵	石广氏丶
𤞨	犭甫
𪮫	扌廿日攵
𬩭	之牛口羊工
𪥘	亠八丁口大
𤙭	牛甫
𬄦	木刂𠂉丶見
𤊣	𠂉木厂火
𢭲	扌貝
𪢡	牛口丿大口冂口
𫼔	手刀
𧑂	虫艮旡
𤞫	犭戈廾
𥛗	示爪臼
𠿂	口扌千臼
𤢾	犭亼口口人人刂
𠺷	口示口儿
𥿗	糸口八
𬦼	耂乚足
𡑓	土木木木
𦀗	糸土火
𪦎	女文厂彡
䕼	艹廿口夫隹
䕼	艹艹口夫隹
榪	木馬
𠁂	耂丁
𡢻	女亻丰貝
𰡚	犭斤欠
𤄱	氵金十目廾
𤄱	氵金匕目廾
嘫	口䏑犬火
𨰺	金言糸糸攵
𥇺	目爿犬
𬟛	宀婁艹丨日
𥎁	予丿木卜口
𨪞	金广龴用
𢸟	扌亻亼口口人人
𢫚	扌工丂
𠞸	鳥刂
炥	火弓刂
𬴕	亠口冂口山乙
𬍎	犭耂曲辰
挰	扌口王
挰	扌口亻土
𢬥	扌氵工
㨕	扌㇕丿又皿
𠧌	丿廾一八巾乂乂乂乂
𢲠	扌耳冖儿
𨗠	之雨二厶
侼	亻十冖子
𬅓	木口石石石
𬎽	用竹
𫾄	扌日一田土
㳯	氵辛
𢸚	扌艹之夂丰
𦁺	糸門
㩧	扌日艹廾水
𢐎	弓禾禾彐
𡀪	召扌非
𢺺	十又八刀
𤈝	火艹乂
𢟕	心糸冂人
呠	口木一
𫉅	艹女口心
䱸	魚臼丨又
靀	雨艹冖一豕
䋎	糸日一
鞸	革甲艹二
𧁷	艹十口广車
脺	月亠人人十
櫊	木門夂口
𨧢	金口力刂
𧄲	艹言艹日大
𧝨	衤言召
𫵀	小心屮凵
𡫫	文口宀一由八
卲	召卩
𠴏	口艹亡
𢭝	扌刀丶心
𤸒	疒日冂厶
𪉽	卜圍乂日四又
𪉽	卜圍乂冖二四又
𥢃	禾宀㇕皿丁
𠼲	口土隹
𣊌	日土隹
𧅫	艹臼乂乂冖見
𬖗	米女又
憦	心火火冖力
𠰀	口丨弓
𡌣	土四七
𬜽	艹石廾
𥊛	目亡月王
𥊛	目亡月亻土
𥘪	示午
𧽈	走巳申丿
𣛣	木門一廾
𦣘	月一中冖口口甘衤
𦸰	艹立丿生
𧜖	衤十目廾
𧜖	衤匕目廾
𥷧	竹氵习习隹
𡎝	土癶一大
𢹈	扌竹立申
𪾤	目戊
𬂙	立申亡月王
𬂙	立申亡月亻土
𣷯	氵之斤
𫽯	虎文手
𣋁	日日耳又
𣋁	日冖二耳又
𨒟	之夂冫
㘖	口立丿彡頁
𡓞	土竹馬
𥯊	竹亠亻夂丶
𬥯	八刀貝行人人止
𣜵	木口丂虎
𫌒	衤糸亠厶儿
𫡍	矢隹中中
𬁑	日犭耂
𡁹	口言禾㇕丿
𪹟	火巛貝
𨐮	辛艹亠凵人
𦵠	艹亻丿糸
𨁪	足酉
𣷲	氵户斤
𥌹	目金白巾
𡠣	女艮旡
𧹪	土火亼冊
㗢	口千日土力
𫱤	禾彐亡女
𡽾	山臣𠂉丶皿
𡽾	山臣𠂉一皿
𦩰	舟千日土
𱐲	爪尹力
𤢥	犭艹日冂厶
㳪	氵不口
𫈘	艹亻亡女
𬴫	長彡木木
挷	扌丰阝
𠊟	亻黽
𫡸	二車一巛工
𬁜	日艹四冖夕
𤹙	疒示口儿
𫴸	小日
𤶑	疒圍大
𫖽	几二行皮
𦾠	艹日十人示
𬔗	下立
𤭷	瓦亼月刂
𤭷	瓦亼月巛
𬡰	衤日召火
𡗅	夕夕之米
䇄	立𠂉乙
𠊛	日一寸人
𢲧	扌艹亠凵人
𥺑	米彐冖又
𬺚	立申丰月
𦫘	𠂊巴乚丿又丶
䇪	竹至
溋	氵㇕丿又皿
掆	扌冂䒑山
𣇠	日女十又
𢵰	扌糸亼口
𬏱	疒氵殳
𬠶	虫宀匕丰母
𤎒	火土半丸
𫼚	扌亠八
𠸦	口手目
𱫻	火尸廿衤
𥆟	目八口儿
𫗻	八頁广十日十月
𪂯	鳥女十口
𪢰	圍口貝丸
蕽	艹曲辰
𡂓	口之亠八冂十口
𢯙	扌矢口
𧋅	虫尸丶冫
𣇡	日巳心
燰	火爪冖心夂
𪜕	耂乚
𫼎	户心午
𢋬	广木山隹
𧃽	艹广亻隹心
𩇆	雨田亠圍口禾
𧱺	豕亻大丁口
芌	艹一丂
芌	艹丂一
𫬕	口木犭耂
𣘂	土厶矢木
𡳰	尸婁十口
𤇩	火弋八
𬋌	火羊豕
𡥌	子日
𩿠	鳥戈乚
䨙	雨氵工一
䨙	雨氵丿士
𨄼	足禾夕夕
𠸾	口月丿之
𧸝	士四貝半
𫵥	尸䒑廾召
𧶄	貝爪尹
㩔	扌尸艹廾殳
𥹙	米召
𬪽	千日土竹
𧈣	虫㇕丿
𥸄	竹言旡旡日
𦢵	月广亠圍口禾
𣎢	月十日十月
𬮫	門一廾午
𠺩	口氵亠厶川
𫺫	心䒑大阝
𡮔	羊大小
𡆂	口丰日虫虫
𨇒	足石石石
𠠙	宀一火日小刂
𡗂	羊工夕夕
𥳃	竹户口攵
𬗱	糸田一木
𬁫	彐キ日且
𥱨	竹丰糸
𥳄	竹宀一由八
𡝕	女巴三
𠝖	廿日刀
穉	禾尸水牛
𡳝	尸毛亠人人十
𥺊	米牛口
𤎞	火巛冂人几キ
𣙭	木竹召
𪉴	卜圍乂甘木
𨀍	足用
𢵨	土半卩又手
𬃻	田木一口乂
𪯯	厂止亼木冫十
𤜠	犭㇕丿
𡘯	文口大
𡃼	口木隹火
稡	禾亠人人十
𧝩	衤行𠂆十目
𧛉	衣木攵
𩷉	魚大八
𫧭	十日十口口口木
蛒	虫夂口
𡅯	口禾爪工彐心
𣎦	月日甘衤
𥦝	穴木木
𥏿	矢門口
𣅙	日一丂
𣅙	日丂一
𫎤	八刀貝刂又貝
𠻓	口冖隹
𡉿	土木
𪬽	𠂊彐心亻立口
㧅	扌刀
𤠳	犭走巳
𫘲	骨九日
𢣸	心言二乂口
𢣸	心言工㇕口
𡳶	艹丨日尸婁
𢭹	扌文口
𤖹	爿立
𬘅	糸田羊大
𪫼	文寸心
絸	糸見
𨤰	𠂉小王田土
𨤰	𠂊小王田土
𨤰	竹八王田土
𦁅	糸衤刀
𩟼	食爪女羊丶艮
𫎼	走巳宀女
𩷆	魚人二厶
𪇎	木木示鳥
𬔋	穴犬下
𪱆	日日甘衤
𨄺	足土隹
𤽶	白尸毛
𠲮	口一巛工
𩯁	長彡婁
𫙛	魚耒
𤇪	火人彡
𨖩	之半目
𩹮	魚甘木
汓	氵子
𪟕	竹甘廾刂
𡅉	口竹門日
𤈜	火至
𧸻	貝長彡乚丿又丶
𫯆	冂一口⺍廾士尸
𨁫	足田土
鱩	魚雨田
𫯏	大弓夕卜
𥠮	禾十冂半
𨅺	足丁耳攵
𨅺	足㇕耳攵
𠒥	小兀广木
𡃗	口木艹日大
𦃮	糸艹亠凵人
𨫋	金工貝
𬺙	立申亻氏一
𬺙	立申亻氏丶
𣕘	木厶口木
𬧗	足糸爪女
𩬆	長彡下乚
𬌽	犭辰寸
𠹳	口夕㐄木
𢬦	扌示乚
𤷰	疒丰キ
𥖺	石皮羊大
𫅜	亼卩羊䒑口
𫅜	亼龴羊䒑口
趶	足丁一
𠃯	禾㇕丿乙
𤁔	氵鬼冫十
䱕	魚𠂉母
𣹕	氵行彐キ
𦙀	月厂又
𦙀	月𠂆又
𦟵	月艹爪子
𤄍	氵酉卯田
𧹦	土火見
𫺦	八刀心甘
𪮚	冂䒑山刂手
𦷬	艹禾弋八
𧊊	虫用
𤠲	犭山一口䒑
𥳐	竹門一廾
𬇚	氵幺㇕
𦹯	十口艹日十
𫆚	月由
𣃲	方𠂉几二
𧑁	虫厶厶厶人彡
𥜡	示𠂉小王田土
𥜡	示𠂊小王田土
𥜡	示竹八王田土
𬎶	生彐火
鬦	鬥冫十
𫊚	艹白⺍木木口
𱏯	田夂口牛儿
㤕	心屮凵
𡁿	口艹勹屮勹屮
𧉻	虫半
𬗔	糸文寸
𬰠	一木頁圍
𠹖	口尸廿衤
啛	口一尹女
槏	木禾禾彐
𤵺	疒申丿
𥇼	目石廾
𬁮	八四日丿大心
𬁮	八田日丿大心
𤷶	疒丰衤
𪦭	女十口烏
𬧲	丁口車
𫎑	貝竹
𪝪	亻尸二コ又竹
𪢷	土亡
𩞝	食囟又儿夂
𩞝	食囟又八夂
𥉪	目氵𠂉母
𤏢	火阝八豕
𠑬	亻食土土土兀
𣰙	毛木木示
𣺻	氵冂大皿
𠶝	口一中彐
𬙞	四土厶七
𩭵	長彡宀㠯
𬮶	門一廾乂𠂇巾
𦟎	羊工䏑
𫁷	竹又又
𠹯	口阝匕匕土
𪄅	乂木殳鳥
𤬸	瓦生
𬤻	豕㇕丿
𫃹	糸之儿⺍
㖗	口山亼㇕
𫏚	足亻立口
𬇧	氵工中
𣔠	木艹斤
𩻛	魚旡旡日
𡊠	土甲
𪇋	鳥山鬼
𬆎	止戊一癶女又
喠	口千日土
𠲝	口文寸
𫦽	艹口丰力生
𫦽	廿口丰力生
𠱆	口㇕丿子
抳	扌尸匕
搮	扌西木
𩯹	長厶彡石石石
𬝉	艹又又又又
𡚡	艹魚禾大
𠽚	丁口千日土
𪇍	鳥之咼
𧕭	虫艹臣𠂉丶皿
𧕭	虫艹臣𠂉一皿
𬉚	氵尸匕日生
𠜬	亻日一刀
𫸕	廴彐キ羊工
𤕔	口丿七八乂
𢯞	扌戈止
𤒲	火广田土火土
𱜝	匚コ心木口𠂊貝
𱜝	匚コ心木口刀貝
𪱊	日生亻丁口
𪿒	石卜了
𫭅	圍扌厶
𠶅	口扌召
𧍇	虫亻一口乂
𢵔	扌尸子子子
𡮊	小土厶刀丶
𫨮	土厶亼十口
𫪿	口氵亻牛
𦖇	耳口力刂
𤜯	犭𠂊又
𡮤	門十丿小
𢷱	扌广婁
𪰏	日丁口
𫱗	女亼口手
𫽝	扌刂又皿
𫻋	心白一中彐
𤎔	火羊丶水
𪴁	木足儿⺍
𣌵	曲𠂊又
𦄌	糸土儿土丸
𦄌	糸土八土丸
𧃌	艹足水日
𠺮	口日土寸
𦝹	月門乂木
𫁜	穴犬石𠂊𠂊
𣴜	氵扌丿七
𨆣	足艹日冂厶
𣨕	一夕口口
𣨕	一夕口丿口
𢴗	扌氵火火
𥆀	目氵工
𫭿	人人土匕匕
𬟻	虫亠八
㵢	氵雨田
儾	亻一中冖口口甘衤
蹆	足之艮
𧰗	一口䒑宀心皿丁
𠝺	甘木刂
𤵪	疒召
𪡵	口氵口月
𧹻	土火土耂
𪵌	殳亻夕夕
㺞	犭臼一乚丨廾
𩶟	魚丿之
𠺾	口王𠂉木
𬟎	艹王廾日一勿
𫫗	口不見
𨷑	羊大門一廾
𦓜	耂匕而大
𩟵	食竹馬
㺝	犭臣𠂉丶皿
㺝	犭臣𠂉一皿
䈧	竹爲
𩺡	魚王刂王
𦗞	耳宀大丁口
𥿥	糸亻士
襊	衤日耳又
襊	衤冖二耳又
𥣑	禾艹千日土
𣱽	氵㇕丿
𧛈	衤亼冊
𠶐	口之匕卩
媎	女耂
𩟻	食日衣口口甘
𩑰	日一頁
𥊡	目車欠
𢝘	心臼工
纙	糸四糸隹
𦝄	月土儿夂
𦝄	月土八夂
鑧	金宀艹見丶
𡎭	土糸亠厶儿
𫶸	巴亻一夕刂
𧊐	虫彐キ
𩗂	風一木
繓	糸日耳又
繓	糸冖二耳又
𦣰	十冂半臣卜
𫦢	石亠人人十宀丰口刂
𩷈	魚小丿力
𤊦	火方攵
𪨛	尸䒑廾至
𥪝	立申中
𤀘	氵艹風
𩃳	雨丰キ
𥯏	竹亻艹廾
𨮇	金艹風
𣖧	木止匕木
𪬧	巳心亠口小
𩺤	魚西木
𪔠	王廾士口䒑十又
𢤛	心四厶月匕匕
㷙	火䒑月刂
𢢬	心人亠乂凵冂厶
𨅿	足走戈乚
𪽳	疒西女
𧓯	虫亻爲
𫄄	糸尸婁
𪩁	山阝且
𡻔	山氵丶艮
𡓃	土石石石
𫗒	食宀女
𫛈	鳥子瓜
𬨻	之木口竹
𪲍	木䒑巾
𩠵	八頁宀甘八木
𪯞	方攵石亠人人十
𧦕	言十几
𠽅	口丰臼
𬡣	衤立口
𪻉	犭文隹
𡃹	口口口甲一戈
𦟉	月疒甘
𢏢	曲弓
𪱯	亡月王立申
𪱯	亡月亻土立申
𩡜	禾日丶艮月
𡚎	四十乚大丁口
𡮌	小行皮
𫹦	十目行土寸
𢵺	扌氵甘匚儿
𢵺	扌氵甘匚八
𢁸	巾方
𣌶	八厶曲
𡍢	土子瓜
𪳼	氵耂二木
𪦜	女氵耂
𤹚	疒耳戈
𬗥	糸心日一
𫙂	長彡婁
𫷍	白巾尸匕
𦟷	月土立口
𠠍	禾丿刀人水刂
𨆠	足艹癶一大
𬚶	䏑丶王
𩸶	魚山石
𠌊	木人人巴
𫳵	宀牛亻丁口
𢶼	扌山鬼
㽳	疒丁一
𫧜	匚口口口土也
𥠬	禾丰一大
𠰌	口一木
𪅭	亻丨夂月鳥
𪅭	亻丨攵月鳥
𡌿	土亠口小
𣗪	木艹人木
𡮆	小門
𦷾	艹廿乚冖巾
𬑚	十目匚巾
𣴓	氵亻牛
𨀿	足二𠂊冫
𩆾	雨虎隹一丂
𩆾	雨虎隹丂一
𥍘	目食土土土兀
𠽄	口扌冖儿木
𠽄	口扌冖八木
𦍉	四糸隹亠八丁口
𬈚	氵丰月了
𪥤	上女
𠾓	口言召
𤄌	扌斤氵戊一火
𬜛	舟竹皮
𪥾	女石竹
𡇸	圍千北
𪩔	山⺍甲一戈
𪩔	山八甲一戈
𧔛	虫癶一口䒑阝
𠻥	口巛田木
𡏣	土自犬
𬏨	疒口丿七
𩆠	雨艹四冖夕
𥰆	竹亠八冖巾
𦡠	王廾⺍人月
𤍉	火山言
𥈹	目穴牙
𧔾	虫禾几頁
𠽎	口氵厂土土
𡎢	人人土夕卜
𡢽	女雨田
𤐓	火氵爪幺大
𪭩	手亻弋
𢸠	扌言田木
𧛷	衤十戈口
𤶾	疒文口
噡	口𠂊厂八言
𢏑	弓半
𬋨	爪尹丁
𥚆	示刀丶心
𢢄	心山日冂厶
𧹫	木木土火
𠁺	中中之土羊
𫣝	亼冊人王
𬆆	不一止卯
𣖞	木大八口
𬈺	氵非心
𫸶	弓刀二阝
𨆹	足辛木口
𥼖	米𠂉母攵
𦤱	自犬臣又糸
𫎄	一口䒑宀㇕皿丨
𫵢	曲尸屮凵
𪭽	扌广土丶
𨠲	酉亻工一
𨠲	酉亻丿士
𢱜	扌行土寸
𢵵	扌艹田木
𬎭	瓦牛巾刂
鮻	魚厶八夂
灲	火刂
𧆄	木口艹白幺幺木
𨼚	阝非心
𤋿	火艹屮凵
𪃱	厂日子鳥
𡁜	口示咼
𢝚	心氵牛儿
𨍄	車目廾
𱜞	巴土儿夂
𱜞	巴土八夂
𡑗	土亻冖隹
槒	木亠幺田
坧	土石
𣅅	日㇕丿
𪵟	毛尸目
𤻪	疒雨而
𪭣	扌㇕㇕丨丶
𥊝	目土半丸
𣎀	月广卜口
𨲅	長刀丶心
撍	扌旡旡日
𬚂	羊彐丨貝戈戈
𥵾	竹禾千日土
𢗷	心水
𤞪	犭口口
𤞪	犭口丿口
𫰅	艹魚禾大
𱢽	宀立申亡月王
𱢽	宀立申亡月亻土
𡀥	口艹白巴
𫆲	月艹十冖子
𪤄	土四土厶
𡅎	口竹旡旡日
𬟖	一火日小艹厶口
𥅦	目耒
𪸘	火土厶
𡌀	土口力刂
𢆭	巛圍乂巛𠂉㐄
𥢬	禾爲
𦟟	月广木木
𦟟	月广十儿十儿
𢚲	心巳攵
𠲞	口扌工
㺯	王大
𤹼	疒虎彡
𥖸	木鬼石
𪩪	匚コ亼口口人人欠
𡒬	土竹甘廾
𤳽	田龍
𬑰	矢半
𡀳	口尹口羊
𡕵	頁夂八丂
𪝄	亻一火丂一
𪺹	犭女又
袊	衤亼卩
袊	衤亼龴
𫠰	下手戈
𥈭	目口口一丂
𥈭	目口口丂一
𫔳	門文キ
𣼼	氵阝木日
𤀛	氵尸匕木人人
𪇨	鳥艹氵甫
𠿚	口艹廿乚木
𪝜	亻丿㠯一巾
𪪈	非心𠂉㐄
𦝂	月白勹丶
𢺜	扌竹习习隹
𬳜	禾日一夕
𦄹	糸扌卜日十
𥹸	米十冖子
𨆒	足氵隹十
𩂕	雨弓刂
𪴻	不一止召
𪱬	月氵爪工一
𪱬	月氵爪丿士
𬞠	艹人木艹勹丶
𥔦	石不皿
𬁶	二乂月
𬁶	工㇕月
𥖒	石心勹日子
𡺐	山耂
𦭧	艹匚巾
苚	艹用
𩚔	食女
炲	火厶口
𫆴	宀弋八山月
𦽰	艹予丿爪尹
𦽰	艹予丿𠂊尹
𫈅	艹八人口
𠽓	口衣八厶
𤉒	火豸
𢹿	扌示曲一口䒑
𤠱	犭土厶矢
㩹	扌田田田冖且
𧿺	足屮凵
𪹘	火行亼木
㵒	氵弓刂貝
𤠆	犭衣口
𩨼	骨丘
𥌬	目广田土八土
𣻁	氵金十
𨄹	足之牛口
𦞹	月辰寸
𣌒	日勿业羊寸
𡭜	門小
䳂	召鳥
𫰣	女示乚
𬔦	立氵扌丸
𨨨	金行一止
𨉞	身土儿夂
𨉞	身土八夂
𥈿	目工貝
𨢼	酉囟儿夂
𨢼	酉囟八夂
𬦳	足豸
𠿃	口女甘木
𫨎	厂人手戈
𪅥	隹夂鳥
𬕨	竹丶艮月
捹	扌大十艹
𥗩	石車凵殳手
𫼢	扌厂止
𥱲	竹虎文
𩜪	食大示
𪷰	氵立日召
𤵶	疒卜弓
𫦨	米力
𩨜	骨巴
𤑸	火臣𠂉丶見
𤑸	火臣𠂉一見
𬏽	疒四貝
𢵶	扌金丿屮
𢵶	扌金一屮
𧼍	走彐火
𫗹	八頁木宀丸
𡋀	土示乚
𪖠	自田廾召
雴	雨立
𬈼	氵亻冖隹
泍	氵木一
嚋	口士㇕工一口寸
𬧕	足𠂊用刀牛
𫤁	亻小冂口十目
𠶓	口丰衤
𡑰	土圍土口衤
𤂩	氵牛儿耂
𩸷	魚石廾
𫡲	二乂下
𫡲	工㇕下
𣔦	木厂土土
𩄳	雨立立
𪩵	行亠巾
𤉖	火車
𧛆	衤水日
𥈲	目𠂊彐心
𥻼	米烏
𧃵	艹十口癶一口䒑
𨃓	足艹人木
𦟐	月馬
𫡦	人彡九
𠺥	召爪冖又
𢬢	扌口巾
㨲	扌艹宀木
𥶃	竹艹四冖夕
𤽀	白了
𠴼	口至刂
𬴟	亠口冂口竹彐キ
𨩖	金艹亼卩
𨩖	金艹亼龴
𬩌	之小兀圍巾
炶	火卜口
𦞣	月又冫虫
𦞣	月又丶虫
𨭍	金非心
𦼔	艹一火日小
笀	竹亡
𠸫	口丰一大
𢅧	巾糸白巾
𤘓	牙宀心皿丁
咹	口宀女
𥓴	石方攵
𫖦	川頁小冂口
𱔂	口亠亻一夕刂
𤺵	疒口立日
𥶰	竹尸八四日
𥶰	竹尸八田日
𡄀	口口艹四十乚
𡄀	口丿口艹四十乚
𦟾	月匚口口口
𠁵	中刂キ廾
𬏊	田丶艮
𥪞	立申冂人
𦝌	月氵土厶
𬹰	自田廾立口
𫏻	婁車
𠵩	口田木
𥒃	石士也
揌	扌田心
𫧧	之車丿廾
𫋟	虫臣又皿
𥺒	米由丂
𡀢	口山亠口冂口
𠶠	口氵厶口
𢰺	扌𠂊且八
𣙸	𠂉木艹屮凵
𠻽	口木𠂉母
𫇍	自犬宀釆田
𣠖	二木言耂
𠿰	口食𠂉力
𦜞	月乂艹廾
𪸝	火口力
𣈔	日广卜口
𦟊	月酉巳
𣾻	氵口耂
𢶺	扌穴𠂊臼
𤳇	木人人田力
𥪅	立口欠
𪽮	疒卜尸
𧶯	𠂊貝艹廾
𱤪	木丿四亻衣
𦀽	糸牛口
𢬭	扌文寸
𫧟	半巳
𠝗	刀心日一
𪣽	又土十冖子
𢆘	𠂉㐄欠
𨅇	口亠人人十足
𪵸	氵土也
𣛯	木氵欠皿
𢜞	心木人人
䣷	酉𠂉木
𬄱	木艹刂又皿
𫠺	上艮心
𪭚	户刂キ廾キ
眜	目一木
𦲿	艹四十乚
𬹯	自田廾艹乂
𢇱	广八丂
𡊳	土生
𱏃	亻丶艮月
𣷭	氵行皮
𪧱	宀甘八冫士口
𥺔	口欠米
𬩉	之木口弓刂
𤙮	牛土火
𫆝	月門十丿
𫾐	扌厂木木止
𫏍	足巳攵
𪇏	三田田鳥
𤞐	犭一亻子
𫯝	上一大
𨱾	長大弓
𤄭	氵日一止頁
𤃤	氵之土土土兀
𪜒	乙士口
𫑆	之十又大八又
𠀖	廿丶
𨦭	金宀牛
𣘃	木艹亠凵人
𨮉	金尹口羊
𫷇	宀口亠巾
𥬨	竹丘
𢈖	广一冂土
𤋷	火丰一大
𬎷	四十乚生
釯	金亡
𪣮	土氵尸匕
磮	石山亼冊
𦰦	艹巳攵
𥊥	目阝𠂊臼
𪩱	巴門木四
𪩱	巴門木日
㖡	口亠亻夂丶
𬗵	糸土半丸
𠺨	口耳心
𧹼	土火耂阝
鮋	魚由
𪽯	疒丨弓刂
𫢖	亻㇕丿竹
𥆁	目一夕刂
樳	木彐工口寸
鴼	鳥夂口
𥽍	米木木示
汿	氵予
𦎍	羊言
𫲴	子艹門木四
𫲴	子艹門木日
𬅧	二欠目
𬅧	冫欠目
𤷖	疒土儿夂
𤷖	疒土八夂
𤌀	火𠂊彐心
𠻋	口廿丿用
𪮻	扌車斤日
𦄆	糸土田土
𡭧	屮凵小
𦲼	艹女石
𨥿	金工丂
𣼍	氵山亼冊
𬨳	之木丶幺㇕
𬨳	之十儿丶幺㇕
𨄸	足日扌斤
𫪄	口刂又土
繮	糸三田田
𠺿	口厂白小
𬧜	足弋心馬
𤹒	广衤土厶
𣗾	亼冊𠂉木
𪿣	石刀二阝
𬏝	疒卜了
𩹫	魚口耳
𣡹	木广耳王十四一心
𤁓	氵王爪午凵
𤁓	氵王䏑午凵
𢭱	扌亻日一
𬲇	亼月刂心几二
𬲇	亼月巛心几二
艔	舟广廿又
𩄎	雨尸目
𫲼	宀𠂊又
𥄯	目亼㇕
𥍎	目日冂厶頁
𫽶	扌巴小兀
𤍆	火車兀
𬥪	士口䒑皮貝
𠑢	亻艹土儿土丸二厶
𠑢	亻艹土八土丸二厶
𤊬	火非
𡮳	四貝小丿
𤢈	犭癶一口䒑
𩂏	雨十又
𫮲	土艹日大土
𣭯	毛大弓
𣵶	氵口欠
𣼭	氵土隹
𨨷	金穴犬
𥳉	竹耂阝
厛	厂口斤
𧒋	虫刂𠂉丶見
𤿭	皮甫
𬇒	气厂白小
𤇨	火不一
𦡥	月氵弓冫弓冫
𬌔	爿心
𫅩	习习一日乂
吿	牛口
𫘿	長彡尹口
𪞍	禾禾彐亼口
𪟶	半小冂口
𬔕	穴牙糸亠厶儿
𡮾	之土土土兀小
䊼	糸止
𨅹	足十日十月
𤑫	火艹之夂丰
𦰤	艹宀牛
𩫛	亠口冂口亠人人十
𫥖	冫亼卩夕卜
𫥖	冫亼龴夕卜
𫈺	艹木亠凵人
𢈱	广禾刂
𥏋	牛儿矢
𪨃	小扌亠人人十
𧟀	衤口口甲一戈
䋦	糸𠂉母
劸	土土力
𢹉	扌禾㇕丿頁
𦼜	艹走𠂉小
𦼜	艹走𠂊小
𦼜	艹走竹八
𱕔	口匚艹𠂇口心
𡏤	土之䒑屮
𱻥	户习习厂䒑屮欠
𪸄	氵臣𠂉丶皿竹
𪸄	氵臣𠂉一皿竹
𫡠	𠂊丶四貝
𩷹	魚卜日十
𠴖	口亻立
𢴏	扌氵爪工一
𢴏	扌氵爪丿士
𬩀	之不口口
𬩀	之不口丿口
𫪎	口心㇕大
𢶟	手山鬼
𣗌	木之米
𡭉	半身寸
𪣰	土四十乚
𢢋	心山立丿彡
埩	土爪尹
埩	土𠂊尹
祱	示八口儿
𬕓	竹丿大小丿
𫸋	广廿一由八亻𠂉匕
曥	日虎田皿
恜	心弋工
𢬤	扌匚王
㤡	心一夕刂
𡥴	子白工
𫒨	金土申
𰴂	衤厶大彡
𥵛	竹曲辰
𧯶	山一口䒑丁口
𫷓	小冖口巾亼冊
𠲤	口氵女
𠹼	口宀辛
𫅠	羊大艹廿乚木
鎇	金尸目
𧍎	虫氏日
𦹰	艹囟又儿夂
𦹰	艹囟又八夂
𠍭	亻立口𠂊又
𨤻	一八巾乂乂乂乂王田土
𬙚	四廿乚
𫵈	門心小
𪪆	干八亼㇕心
𠬖	土厶衤甫
𧎷	虫勹屮勹屮
𬞨	艹火爪丨日
𠷤	口月勹巳
蓃	艹臼丨又
𠺻	口糸𠂊又
𣖛	亠人人十一木
𠜯	牛口刂
𩬪	長彡丿之
𤇤	火工丂
𧚢	衤亠口儿
𬥓	貝半
𬎵	生門十丿
𦡟	北月土儿夂
𦡟	北月土八夂
𪟆	亠厶月刂
𩺪	魚舟殳
𪟙	艮力
𬏑	田立申
𪮒	手手目
㳥	氵王廾
𬕩	竹扌卜日十
𡒪	人人土䒑八皿
𠇕	亻巴
𪪄	干八刀丶心
𤊢	火日一寸
𪱁	日勿田土
𢀱	匚コ魚禾
𫫥	口氵宀示
𫮦	土非心
𡼹	山木土儿夂
𡼹	山木土八夂
𣏒	木丸
𤠃	犭一巛工力
𠜮	𠂉母刂
𤻳	疒石石石
𩺦	魚辰口
𤏬	火人户口刂
𫱅	女干亼口
𬜑	舟力
𬟗	艹丨日宀婁
𡬼	冂䒑山刂寸
𨬋	金冖二召儿
𢗽	心匕匕
𬴝	亠口冂口土土土兀
𫄉	糸足夂口
𪂠	田木鳥
𪶛	木目水
𫏈	足小兀
𬡬	衤千日土力
唹	口方人冫
𥾋	糸㇕丿
𨎞	車士方攵
𨎞	車土方攵
𨎞	車丰力攵
捛	扌口口
捛	扌口丿口
𢝛	心丰刀大
𣋜	日木木示
𫮡	土氵火火
𢺝	扌艹糸圍人皿
𣠶	𠂉木耂見
𧌎	虫冊廾
𬃤	木臼丨丂
𨂗	足子瓜
𫭐	圍口口口
𫭐	圍口口丿口
𫘖	糸氏馬
椊	木亠人人十
𬞮	艹之車竹
𣕬	木丰母
𬚊	耂匕了
𧍐	虫亠亻一夕刂
𡮇	亠人人十小
𣥱	止一口乂
𪝬	亻石亠人人十
𠶡	口石廾
𠇼	亻爪丁
𡀲	口言亠凵人
𠱜	口一亻子
𥭏	竹厶牛
暏	日耂
𬈈	氵二刂一止
𡓠	土金廿日
𨁦	足王廾
㷝	火穴犬
𨯸	金禾几頁
㳶	氵爪子乚
𬗀	米丁卜口頁
𦄣	糸衣八口
𦮴	艹𠂉㐄
𧄈	艹厶口一火日小
𢯦	扌木人人
𨨠	金勹米
𠟲	宀釆一丂刂
𠟲	宀釆丂一刂
𫤾	冫乙
𢠿	心爲
𨤧	田土𠂉小
𨤧	田土𠂊小
𨤧	田土竹八
𲄱	身臣𠂉口口口
㓟	皮刂
𢶂	扌之冖車
𥖖	石皮扌巴
𪞼	亠乂凵羊二欠
𪞼	亠乂凵羊冫欠
𩩿	骨立日
𤲂	田亻八下
𥍖	目臣𠂉丶四見
𥍖	目臣𠂉一四見
𢫄	扌木乚
𪇫	鳥鬼冫十
𪲂	木乙日
𫯗	夕夕氵口月
𨸈	門羊大
𧞊	衤𠂊用刀牛
𩓛	尸㇕口頁
𠶦	口广由
𡂮	口耒日冂厶
𢴿	扌十日十月
𬖾	米皮頁
𬈿	氵宀㇕皿丁
𤼕	疒耳立日戈
𢀨	匚コ丶艮阝
𬡢	衤宀人大
𠶢	口氵由
𫴮	日一寸亻二
𠑋	人乂乂乂乂十王廾
𪬤	自心弋八
𪿐	矢車亼月刂
𪿐	矢車亼月巛
𣠳	予丿木𠂊厂八言
𡂂	口言二乂口
𡂂	口言工㇕口
莯	艹氵木
檊	木十日十人干
𥡗	禾馬
𪫦	心𠂇工
𫶺	十艹一兀𠂊厂卩
𦷮	艹心二乂口
𦷮	艹心工㇕口
𡓁	土四厶月匕匕
𬛑	月白匕旡
銙	金大一丂
銙	金大丂一
𨅄	足車欠
𩆴	雨虎田皿
𬈎	氵禾冫十
𭉆	口心艮
𠶋	口艹亻八
𫃒	米艹甘匚儿
𫃒	米艹甘匚八
𨆿	足門夂口
𫯙	夕夕立丿禾禾彐
𣵴	氵口亼㇕
𪭀	辛刂辛心
𨡼	酉刂又皿
𩻺	魚非心
𠽋	口匚艹𠂇口
𫤋	言二乂口亻匕卩
𫤋	言工㇕口亻匕卩
𢂎	巾由
𫜍	鹿夂口
𠱍	口犭卩
𤒘	火竹馬
𫗀	几二氵𠂉母
𬌖	艹白幺幺木爿
𥘂	石言糸糸攵
洃	氵𠂇火
伩	亻文
𥬊	竹斤
𪺃	火勹巳小冖口土
𬕫	竹由丿皿
𫿐	巳攵户斤
𤂭	氵酉亠人人十
𬋗	火勹巳广廿巾
𣳔	氵用
𢪭	扌工一
𢪭	扌丿士
𨦽	金文口
𡅒	口扌一白冖心夂
𡓂	土癶一口䒑阝
𢩽	扌巳
𢢁	心尸子子子
𫃼	糸米冫十
㨔	扌戊一口
𤉗	火耂子
𤶽	疒十冖子
厙	厂車
𡄭	口行人人止耳
𬛗	月門心
𫕡	雨北
𫨅	厂一白
𪤷	夕巾
𤹽	疒言冂人
𢬐	扌九日
𠥤	匚艹𠂇口酉
𬪁	卯丶丶口巴
㲸	氵乙
𡅋	口木臣𠂉丶皿
𡅋	口木臣𠂉一皿
𠳚	口巳攵
𦟜	月丰貝
𫌕	衤厂木木止
𡙧	大弓艹亡
𨄻	足宀一由八
𫎚	四貝竹
𣄬	亠八冖方厂禾禾止
𡀬	口石亠人人十
𢠥	心十日十𠂉乙
𢥈	心虎田皿
𫽠	扌爪田
𦵜	艹氵西
𠠉	皮頁刂
𬚱	䏑毛
𧔜	虫車斤日
𠓐	小兀火火冖木
𩘣	風丰糸
𥑠	石甘
𪱜	厶口月
𦃯	糸田皮
菻	艹木木
𦁻	糸白工
𠄩	厶口二
伮	亻女又
𫽟	扌殳召
𡦮	子艹癶一口䒑
𦅮	糸人乂乂乂乂十
𨈒	身卜
𡶁	山丿屮
𡶁	山一屮
𠫆	厂日子艹厶口
𪳨	冖儿干田木
𪳨	冖八干田木
𬨱	之阝且
𲉯	文隹十冂半
㯝	木足夂口
𪇪	扌亠八冂十口鳥
𪫆	氵彐
𪜛	爪子乚𠂇巾
㗕	口甘冂土
𪶟	氵殳手丶
𫶮	工艹二厶
𣔝	木之丿屮
𣔝	木之一屮
𨆂	足一大非一
𠰃	口工一
𠰃	口丿士
𠗤	冫行丶王
𠙅	几立
𧌂	虫止癶
𠁄	亼冊下
𡑳	土尹口羊
𦜘	月爪子乚
𠸣	口糸工
𢭿	扌氵一巾
𡼇	山囟儿夂
𡼇	山囟八夂
𫫫	口一白冖夂
𢙩	心耒
𪯫	冫十丘
𦙣	月木
𪡯	口貝門
䚂	土火見
葻	艹風
𤴵	疒弋
𥵕	竹日召火
𬕰	竹牛儿夕口
𪪻	弓一冂人
𤎶	火爲
𨗛	之十日十月
𪒳	四土火氵厂白小
𪒳	田土火氵厂白小
𣛧	木木木木
啩	口土土卜
哬	口亻丁口
𩖫	風方
𡥙	子召
𠼖	口木木女
𤠂	犭艹厶口
𨇛	足耂見
𩝇	食甘木
䁠	目禾禾彐
𪦍	亡女小兀
𦝋	月門
𥱯	竹日土寸
𬗢	糸四十乚
𢺎	扌月巛圍乂巛
𥈺	目爪丨日
𡳥	尸石亠人人十
𠶌	口之斤
㮧	木烏
𬖉	竹立申亡月王
𬖉	竹立申亡月亻土
𧋍	虫扌斤
𥽵	米糸土土土兀
䐠	月艹亡川
𠁹	中臼一乚丨廾
𣫷	𠂉母半
𥉮	目䒑屮月
𫹰	心門
𠅜	亠亻一夕刂
𥞵	禾大人人
𤮄	瓦一口冂八丁
𨄽	足阝𠂊臼
𥭵	竹刀二阝
𪢃	口亠乂凵八夂
𪵧	气士方攵
𪵧	气土方攵
𪵧	气丰力攵
𧒇	虫犭耂
𫗄	几二亼月刂心
𫗄	几二亼月巛心
𠯾	口亻九
𪠭	厂又阝且
𪠭	𠂆又阝且
𫥿	亠八乂刀
𠲣	口丿皿
𢤠	心夫夫車
𢣇	心立日欠
𬇓	气之土羊
𣎖	月土半丸
𫅮	习习立申
𦒵	耂匕口
𡖡	卜口夕夕
𢱨	扌文糸
𣖜	木田月
㮔	木千日土
𣉳	日四土厶
𢹦	扌亼口口人人欠
𫏪	身虫
𡚄	大卜日十戈
𫵨	尸䒑廾牛巾刂
㴥	氵山小月
𥆺	目酉
𪪏	广卜尸
𥯇	竹爪子乚
𧳇	豸亼口
𦢢	人人人月尸至
𢫅	扌丿七七
𤾷	白扌业半大
𤭶	勹乂凵月瓦
𬍆	犭耂文
𥉭	目扌斤口
𡦅	子勹屮勹屮
𫲃	女亠圍口示
𣄥	亠八冖方隹又
𣔤	木亻一口乂
𠖤	冖一兀非心
𥢅	禾厶卜貝
𤀞	氵艹耂
𡏧	土亻立口
耚	耒皮
㝵	日一寸
𩦓	馬門一廾
𡨌	宀寸中
𨃶	足木夂口
𥓅	石口口
𥓅	石口丿口
𢸡	扌齒
𫐴	之豕八
𠼿	口文口心
拁	扌力口
䱚	魚彐水
籚	竹虎田皿
鮽	魚亼木
𠁟	立立禾禾彐
𧀞	艹田木一口乂
𪅴	亞心鳥
㦡	心白幺幺木
𥹯	米耒
𧫼	言广木木
𧫼	言广十儿十儿
𡌡	土弋弓
𬒊	石人二厶
𪯾	方口貝
𠞟	亠口冂口刂
𠆳	人上
𠻇	口木申丿
𧤂	土儿夂𠂊用
𧤂	土八夂𠂊用
𧜙	衤工貝
𦤠	自犬𠂇火
𠯦	口七刀
𬫀	田土予土土
𣿌	氵之日勹亡
𫺱	自心卜了
𠟹	刀予頁
𠖈	冖一兀下
𧑅	虫走戈乚
𫧂	牛口勹丶
䀨	目舌
𤴥	疒乙
𣐄	木中
𢟹	心辰寸
𧰦	乙豕
𫑑	之咼𠂉㐄
㨴	扌十日十𠂉乙
𢢊	心阝八豕
𢷃	扌門亠巾
𥱴	竹扌甫
𥸍	竹門口口甲一
𡙵	大目艮
𥺐	米口斤
𬑉	一木目
𤢇	犭竹彐キ
𫔹	門亠巾日皿
𢭗	扌丶艮
𤴬	疒刀
𨦦	金宀丁一
𫇊	自宀子
𨁲	足口巴
浽	氵爪女
噽	士口䒑口不一
𢘾	心女口
𱿈	尸婁艹丨日
𢷴	扌匚中一貝
𩆍	雨氵爪午凵
𩆍	雨氵䏑午凵
𤯩	王廾生
𤞽	犭艹亡
㨘	扌小丿目
𣔧	木女石
𬕷	竹亼月刂心
𬕷	竹亼月巛心
𡂹	口宀釆田
𣋻	日艹四戈人
𦞎	月立丿彡
𥶁	竹辛木口
磢	石大乂乂乂乂
𤔾	艹冖一豕爪
𫘑	馬羊大
𨃽	足辰寸
𥼲	米丁耳攵
𥼲	米㇕耳攵
𠵚	口山厂干
𢅆	巾艹日月
𥗜	石口口甲一戈
𡞗	女丰キ
𪡽	口刂キ廾キ
𣉕	日又又又木
𨄾	足宀大丁口
𢷰	扌車一巛工
𢲢	扌阝亼木
𡄮	口金木四
𡄮	口金木日
㖣	口立口
𤮑	瓦非心
懓	心爪冖心夂
𤇌	火十口
𡈩	圍立田土
𠠭	衤刀亻旡旡日
𪩜	山乂乂鬼
㦉	心士冖一口䒑
𬏩	疒小丿力
𣞪	木四土火土
𣞪	木田土火土
𪥀	广亠圍口禾夕夕
𣻀	氵糸冂人
𤹓	疒尹口阝
𩢦	馬夂冫
𧊉	虫丿之
𡃌	口厂亻鳥
𠊜	亻女石
𪝅	亻木攵
𢵹	扌疒𠂉母
𪮞	扌禾手丶
𤺳	疒尸水牛
𬙽	羊䒑口亼卩
𬙽	羊䒑口亼龴
𫑱	丶艮阝十日十月
𬧘	足火火冖木
𨪀	金甘木
𫇡	舟艹門木四
𫇡	舟艹門木日
𱑮	衤甫土厶
㖸	口虎匚一
𨒺	之小兀
𣟩	木禾几頁
𫳹	宀弋八山兀
𡝔	土厶力女
𬃪	木亠八丁口
𢋠	亠八冖巾广氏一
𢋠	亠八冖巾广氏丶
𥄭	目午
𡎛	土八刀皿
𡳪	尸毛土隹
𪓇	四土火十目廾頁
𪓇	四土火匕目廾頁
𪓇	田土火十目廾頁
𪓇	田土火匕目廾頁
𩇍	雨馬田糸
𫬪	文口米夕㐄
䗲	虫米夕㐄
𡓔	土广亠圍口禾
𫃵	糸婁
𫢠	亻艹尸
𢳁	广非手
𥷺	竹言艹日大
𨉑	身口王
𨉑	身口亻土
𪳋	木丂亼㇕心
𬜕	舟八口丿几
𬜕	舟儿口丿几
𬜕	舟几口丿几
沲	氵𠂉也
䕯	艹西示瓜
𦄈	糸金刂
𠲜	口爪尹
𣙧	木目艮
𪽠	白⺍儿由
𢴎	扌月八口儿
𪭘	户匚コ
𪀅	瓜鳥
𣦮	亠人人十止戊一癶
𥗐	石石石石
𬗲	糸亻丨夂彡
𬗲	糸亻丨攵彡
𢚼	心山𠂊又
𤢽	犭斤斤貝
𪶎	氵扌召
𡳺	尸毛白鬼
𢤫	心臼一乚丨廾キ
𥿺	糸亡女
𬊐	卜尸𠂇火
呌	口冫十
𪅦	鳥圍戈口一
䈒	竹十冂半
𪲇	木曲
𤻽	疒齒
𬊬	火卜口火
𥟼	禾艹不
姂	女丿之
抷	扌不一
𨀎	足立
𢺍	扌艹巛圍乂巛
𪵰	氵弓丨
𡃔	口扌一火日小
𪆥	鳥穴牛口
𬦋	走水丶
𬲂	几二亼月刂
𬲂	几二亼月巛
𤬀	瓜亼木
𡃒	口扌业半大
𫀵	禾宀下乚
𢲱	手甘冂土
挕	扌耳
𫔬	一力門
𣅗	日巳
𣻂	氵扌斤口
𥋽	目四卜日十
𢲩	扌糸𠂊又
𧒊	虫矢口日
𨐷	辛言𠂉匕
𣻕	氵广木木
𣻕	氵广十儿十儿
𧘇	衤
𫭻	土巳心
𢹌	扌之尸水牛
𠼽	口爪見
𬑫	目一木弓⺍甲一
𬑫	目一木弓八甲一
𫹄	皮彐
𬩛	文寸之豕
𩷳	魚尸毛
𤃡	氵匕禾頁
𫕲	雨之亼月刂
𫕲	雨之亼月巛
𤷵	疒土皮
𦞢	月圍豕
𠸢	口一口田
𧸰	貝車一巛工
𡮲	小言土寸
𡳀	尸毛𠂊厂卩
𨄊	足䏑又示
𪿽	石𠂉木亼冊
𢰳	扌西女
𱚹	尸丶且
𫕨	雨厶大彡
𤷍	疒甘廾
𡂯	文口丶艮月
𪬼	八刀心刂又貝
𢂌	巾亻弋
𨘱	之木口爪尹
𨘱	之木口𠂊尹
尙	小冂口
𢺀	扌言艹日大
䘹	衤亠人人十
𤠚	犭丰糸
𦄶	糸口艹亻八
𠻵	口艹犬廾
𠹗	口扌斤口
嘑	口虎爪丁
𬔒	穴氵冖儿木
𬔒	穴氵冖八木
𥓶	石夂田
𣼬	氵日扌斤
疿	疒弓刂
𥔧	石千日土
𬫤	金四十乚
𫻅	心白山𠂊又
𤶎	疒𠂉木
𤉔	火亻𠂉匕
𬍏	亠幺⺍十下
𡂡	口婁攵
胒	月尸匕
𫼻	扌亻白
𢫆	扌木一
㙮	土竹亼口
𨥧	金丿之
𣇫	日田木
堛	土一口田
𫘴	骨尸至
𩠱	八頁之丿㠯
𧀜	艹火爪臼
𥢂	禾广木木
𥢂	禾广十儿十儿
𢳞	扌耳冂土
𬓓	示乚木艮
𠀴	屮凵下
𬠄	虫圍巾
𣦍	宀且一止
𩐛	立日瓦
𠲦	口戈𠂇
𥽩	米之尸水牛
𡋃	土耒
𣞄	一木亼四日
𠧍	雨而丿廾
𫇂	尸至月巛亠乂凵
㹠	犭丿屮
㹠	犭一屮
𫂮	竹甘廾言巳
𣵰	氵文口
𪤾	夕十日十月
𩄐	雨阝夂㐄
𫵃	小彐皮
𤍶	火田糸
𦵚	艹女又心
𧍉	虫广氏一
𧍉	虫广氏丶
𠋥	亻尸目
𠶄	口子丁口
䅘	禾木人人
𬎳	生木
𥐐	矢一口䒑衣八口
𨁰	足口欠
𠾼	口糸𠂊巴
𤑯	火亼口口人人刂
𠿒	口日勹亡欠
𠦿	禾𠂉小丿廾
𠦿	禾𠂊小丿廾
𠦿	禾竹八丿廾
𨗵	之气土羊
䃣	石爲
㤝	心亠厶儿
粡	米冂一口
𬢞	言竹
𫵛	尸丶冫寸
𡓎	土行㐄口㐄
𦧷	舌广禾禾彐
𩙳	亼卩乙冫丿刂乙冫
𩙳	亼龴乙冫丿刂乙冫
𦬑	艹女
𨁨	足犭王
𡛔	女下乚
𠄦	二𠂊又
𨇷	足禾女鬼
𥫟	竹巳
䘆	虫宀丰四心
𬹷	齒宀丁一
𡁼	口氵西示
𨁯	足土火
𣌝	日日衣口口甘
㦆	心虎爪丁
𠐞	亻石石石
忇	心力
𪷞	氵艹刂又皿
䤵	金非
𣡙	田木木口𠂊貝
𣡙	田木木口刀貝
𨙖	之龴用亠幺⺍十
𡫡	宀牛門口
𪡗	口斤欠
𠝫	羊大刂
衴	衤冖儿
𢆕	干八厂又
𢆕	干八𠂆又
𠀫	甘廾丿
𠝔	女厶口刀
𠶈	口衤土
䕱	艹一口䒑頁
𠹾	爪冖又召
𤉛	火人人土
𪄌	工貝鳥
𩼁	魚耂阝
搩	扌夕㐄木
𫺒	心門日
𪩥	匚コ文口
𢮑	扌彑水
𤆷	火亻匕
𧺕	走勹丶
𨀈	足北
𱓕	口女又弓
湈	氵甘木
喡	口㐄口㐄
𥊦	目予丿夂力
槯	木山隹
𣙺	木囟儿夂
𣙺	木囟八夂
𭋙	口示彑水
𣾃	氵戊一口兀
𠛤	卜口刀
𨇶	足穴白方攵
𨆞	足曲辰
𠁪	工一中
𠁪	丿士中
𤹔	疒亠八冖方
𠗸	冫工貝
𤓆	火艹臣𠂉丶皿
𤓆	火艹臣𠂉一皿
𫌗	衤言身寸
𪩮	巴土儿夂
𪩮	巴土八夂
𦏒	羊大艹田
𠸗	衤刀十口
𠺶	口糸冂人
𪧡	十目宀寸
𠫏	厂禾禾止亠人人十
𥓹	石廾手丶
𥊙	目囟儿夂
𥊙	目囟八夂
𡑩	土鳥衣
苝	艹北
𡳹	尸毛四厶月匕匕
𠲔	口大八
𧶫	貝丰衤
𦽔	艹木木示
𬬐	金千日土方
昛	日匚コ
橊	木一卯田
𤷭	疒白勹丶
喎	口咼
𣑷	木小大
𤀙	氵口烏
𫖼	几二一木
𤾯	白氵廿巾人人
𫽘	扌木口力
𠚢	四糸隹屮凵
𨉓	身亼冂人
𣒲	木宀牛
𫆢	土儿夂月
𫆢	土八夂月
𪛇	龜圍口十圍口
𬁖	日生宀牛
槈	木辰寸
𦀌	糸女口
𤽵	白扌九力
𦆚	糸鳥衣
𪳌	木土且力
𥆡	目亼㇕口
𡎞	土卜貝
𢵱	扌門一廾
𩸱	魚金
𨼋	阝虎业
𨼋	阝虎丘
𬂆	丶艮月竹
𠺽	口乂木殳
𬃈	木乂乂攵
𠱋	口由
𢹧	扌酉鬼
𫕾	四十目非
𫶼	巴辛木口
䌑	糸臣又土
䕺	艹业半耳又
𩛷	食不口
𫯍	夕夕丁
𣨰	扌丿七一夕匕
𥀪	皮亠乚凵隹
𦨻	舟小兀
𣀟	巴婁攵
𦆙	糸雨田
𪨀	小屮凵
𬊨	火女又弓
𬔙	刀二立
睸	目尸目
𠊚	亻日一寸
鯜	魚立女
𨎟	車田夂口
𢥉	心艹氵日一勿
㗶	口癶弓殳
𡮹	小丿艹冖一豕
𣠑	木竹之夂丰
揞	扌立日
𧯄	禾日八人口
𡮛	小氵日土
𠟤	羊䒑口刂
𦲵	艹行一止
𫫞	舌亼㇕心
搙	扌辰寸
𩆬	雨业冖一豕
𠶞	口心生
𡅠	口糸黽
𥺓	米口口
𥺓	米口丿口
妸	女丁口
𨅸	足竹土寸
𠯼	口亻丁
𦘹	月山
𨮶	金氵西示
𧍏	虫女十口
𨦩	金亡女
𧟁	衤馬䒑廾
䀡	目卜口
𧚭	衤䒑廾
𤝹	犭𠂉木
𠺸	口氵彐冖又
𫤒	亻匕頁艹冖木
𩛂	食女又
𡃏	口阝𠂇工月土
𦟒	丿屮月𠂊厂卩
𦟒	一屮月𠂊厂卩
𩈂	非虫非心
𦄞	糸門口
咘	口𠂇巾
㧾	扌勿心
𡂱	口癶一口䒑阝
𣜴	木亼月刂心
𣜴	木亼月巛心
𤹖	疒車干
𫸐	广廿一由八之豕
㩇	扌彐キ田一
𨑻	之冖儿
𦵘	艹而女
𪢠	口艹門木四
𣘄	木言丿七
𪶼	氵小丿士口
𥿠	糸𠂇巾
𫅕	羊厂氏
㹦	犭召
𢯰	扌行彐キ
𠴊	口口口
𠴊	口口丿口
𡛤	半女
𣿅	氵艹千日土
𪘬	齒厂土土
𫅸	耂匕女禾禾彐
𫥕	冫亼卩甘
𫥕	冫亼龴甘
𬞑	艹口十冂半
𤍋	言𠂉乙火
𪄞	鳥勹屮勹屮
𪟒	方𠂉矢刂
𫣪	亻户冊小丿
𬅉	木艹門木四
鮧	魚大弓
喐	口𠂇月阝
𤎓	丰月彐火
𬹙	十目廾四土火
𬹙	匕目廾四土火
𬹙	十目廾田土火
𬹙	匕目廾田土火
𢲛	扌行走
箻	竹行彐キ
𤵡	疒爪丁
𦖑	耳宀且
𡗊	夕夕土土土兀
𦼠	艹門一廾
𬠥	虫王廾心
𬲢	食土土土兀夕夕
𤊠	火石廾
𣇞	日亼木
𢵧	扌門日
𤑈	火行山王攵
𥿤	糸丘
𫷝	干八亻丰月
啨	口丰月
𬨿	之米二厶
𤾱	白宀心皿丁
𬄯	木甘廾石
𤇦	火戊
𩓜	艹亡頁
杺	木心
𪜀	十乚
𥖑	尸毛石皮
菷	艹彐冖巾
𡓅	土艹阝亼㇕二厶
𥹞	米申丿
鐱	金亼口口人人
𤶻	疒見
𡎠	土㇕丿又皿
𬒜	石卜了見
𪬌	心刂又皿
𫄺	午凵口王
𫄺	午凵口亻土
㦃	心立丿生
𡙦	勹屮勹屮大
𪨞	尸婁匚巾
絬	糸舌
𣌺	曲口凵
𡀨	口衤甫
𢩭	扌寸
𡄥	口亼口口人人欠
𬐂	癶一十乚士
𨪝	金虎文
𱤔	木艹又又又又
𡚝	大目目隹
𫁚	穴𠂊用冫十
𥾵	糸厂又
𥾵	糸𠂆又
𥵙	竹四卜日十
𤲌	王廾田
𠰳	口一冂人
𪃲	鳥耂
𪧺	日一止寸
𫸎	广廿一由八丰月
𫢋	亻一大
𡌠	土亻氏一
𡌠	土亻氏丶
𬌌	爿釆田
𫽰	扌亼口日
䐥	月八厶习习
𤵹	疒士口
𡡇	女羊皿
𧀓	艹尸婁
𧓭	虫糸白巾
𪫢	心卜了
𢵸	扌隹木
𪭄	心宀夂口頁
𡪦	宀氵耂
𬚿	䏑門木
𪺦	爿月廿日
𫦑	羊火刀
𥋕	目欠皿
𠝻	甘匚儿刂
𠝻	甘匚八刂
䁲	目四貝
𡎜	土十冂半
𣼫	氵田土予
𠓀	牛儿田夂口
㜮	女臣𠂉丶皿
㜮	女臣𠂉一皿
㦓	心䏑犬火
𨓡	之王廾
𤠄	犭爪丁口
繏	糸巳巳艹廾
𫔦	午門一廾
𧾿	足了
𦁼	糸木攵
𪮀	手阝一兀
𢤽	心臼冂一口廾
𤎍	火圍戈口一
𫤕	亻匕頁西示
㾄	疒由
𢢆	心羊䒑口
𧑒	虫亠口子攵
𫏄	足甘
斍	文見
𣑎	木䒑下
𬘏	糸火土土土兀
𨅂	足不見
𪴽	不一止女小丿
𨅷	足阝八豕
樶	木日耳又
樶	木冖二耳又
𢢇	心日耳又
𢢇	心冖二耳又
𩩩	骨丰衤
𨇸	足竹旡旡日
𬆸	母亠圍口示
𡨸	宀丁宀子
𨆸	足厂白小心
𠏦	亻勿亠口冖丁
𤏫	火竹彐キ
𣾸	氵扌日一止
𫸍	广廿一由八卜日十
𧉙	虫丿屮
𧉙	虫一屮
𬨺	之車上
𨼼	阝丁口爪子乚
𪹏	火羊大
㴷	氵耳冖儿
𥯓	竹甘匚儿
𥯓	竹甘匚八
𪰛	土寸日
𫹭	㇕丿心
柉	木丿之
𪐢	四土火士
𪐢	田土火士
𣞾	木艹婁
𫕸	丰月竹
𢜡	心立女
𫩓	口丿几
𨫇	金月䒑大
𦹻	艹氵爪工一
𦹻	艹氵爪丿士
𢘽	心申丿
𢶒	扌亼四日
㤥	心亠凵人
𢠯	心丶艮月
𡍜	土門
𫃡	糸立
𨃌	足扌土寸
𡂄	口皮頁
𣻽	氵月一巛工
𤶹	疒尸㇕口
𦠱	月竹亻戈
𩍓	革亠乚凵隹
𡻖	山口貝
唩	口禾女
𫦘	𠂊四儿夕刀
𢗖	心工一
𢗖	心丿士
䋖	糸彐キ
𢙫	心圍大
𥻙	米羊大
𫲬	㇕丿子耂
𥋼	目人亠乂凵冂厶
𥙒	示乚土厶
㗂	口小丿目
𠱇	口穴
𪝩	亻羊圍巾
𠅳	亡口貝
㘓	口門木四
㘓	口門木日
𨧠	金月干
𢞆	心立丿彡
𪮏	手田心
𥋔	目山一王攵
𪷧	氵尹口羊
𫭚	土小
𬦹	足夂木
𫆶	卜日十户月
𤇣	火生
䁐	目艹冂大
𦝬	月穴犬
𦞓	月氵𠂆亻
䰼	魚亼㇕
𨮻	金广田土八土
𬍉	犭勹口乂乂攵
𠿮	口食欠
𫭕	亼冊圍口貝
𫛕	穴牛口鳥
𠹵	口日宀女
𥛭	示乚隹又
𧙼	衤厂止
𣑺	木虫
𥼕	米竹立
𡡅	女鳥
㳝	氵亻工一
㳝	氵亻丿士
𡅩	口曲一口䒑𠂊巴
𢞂	心八刀皿
𬨟	之八刀
𥽇	米戊一口心
栣	木亻工一
栣	木亻丿士
𩅛	雨之夂丰
𧁹	广車艹十口
𡂒	口斤斤貝
𪷗	氵月鬼十
𥆻	目口口
𥆻	目口丿口
眪	目一冂人
𤊩	火木木
萻	艹立日
𬂻	木門一廾
𧿑	足弋
𬞁	艹日十口儿
𡉾	土心
𡹟	山木冖儿
𠝓	亻夕夕刂
𪩼	巾爲
槶	木圍戈口一
𬆘	一夕匕宀女
𧙻	衤彐キ
𢭼	扌女小丿
䗔	虫亻コ矢
𩸴	魚矢口
𤺰	疒金欠
𫰄	爪幺大丁口丁口
䐏	月丰日
𧥔	巴𠂊用四勹虫
𪟚	夕口力
𣛱	木穴𠂊臼
𨎆	勹屮勹屮車
𠿈	口禾火心
𠥈	匚土欠
𫉱	艹米丶艮
𢭭	扌火土
𢭂	扌宀牛
𥿡	糸尸匕
嘺	口丿大口冂口
藞	艹石石石
𲌀	馬糸夂冫
𫿟	扌非乂乂攵
𡎟	土禾日
𪦼	子白勹丶
𫣸	亻八四日士
𫣸	亻八田日士
𢁋	巴阝土儿夂
𢁋	巴阝土八夂
𪗀	自田廾日勹亡欠
𫰤	女米
𧒉	厂一口䒑寸虫
𪟽	卜了
𢙬	心亻尹
𪽐	丿田亻八
𡁤	口門夂口
𫃈	米臼丨丂
鋾	金勹午凵
𡮘	甘木小丿
㖻	口予丿木
𬱶	几二幺㇕
𧕬	虫示曲一口䒑
𠸤	口行土寸
𡂈	口亻业半大
𪢈	𠂆一口婁
𱚫	小丿矢隹
𤌋	火鬼
𢭬	扌亻半
𦛽	月口亼㇕
𡃳	口臼冂一口廾
𬌣	牛土寸竹
𠉟	亻木千
𫽖	扌阝且
𡜤	女土也
𥯝	竹穴犬
𢴕	扌宀一皿丁
侱	亻口王
侱	亻口亻土
𣢹	耒欠
𠀳	厶人下
𫫹	一大口立丿彡
𤔯	爪竹彐キ
𣻉	氵廿乚冖巾
𫆻	月匕日阝一兀
𢫙	扌亻弋
𩼷	魚业羊寸
𣷱	氵亻一口乂
𢘬	心𠂉也
𡋿	土口口
𡋿	土口丿口
𫶻	巴臣𠂉丶皿
𫶻	巴臣𠂉一皿
𡀫	口亠圍口禾
𡀤	口竹丰寸
𡚚	大木口𠂊貝
𡚚	大木口刀貝
𫽅	扌土厶刀丶
𢵫	扌八酉大
𢬅	扌小大
𥫭	竹女
𬙾	羊大廿乚木
𧸓	貝氵耂
𡰏	兀氵亠口小
煏	火一口田
𣛪	木彡頁
𤾓	一白木木
𡵺	山勹厶
𫸽	弋弓大申
𪓈	四土火艹丿㠯辛子
𪓈	田土火艹丿㠯辛子
𠾺	口羊䒑口
𩘫	風氵𠂉母
𪧍	宀一兀下
𪬮	心耳口王
𪬮	心耳口亻土
𦟹	月山亼冊
䢦	之亠幺⺍十
𬛡	月日一勿西示
𠶉	口亻工一几
𠶉	口亻丿士几
𨅍	足門日
趂	走𠂉小
趂	走𠂊小
趂	走竹八
𡐮	土爲
𫧇	匕匕
𢪀	扌卜㇕
𩄏	雨風
𬧾	雨田車
𦟼	月門十丿
𧏷	虫亠幺田
𪀚	鳥戈𠂇
𤚆	牛阝皮
抩	扌冂土
𫮢	土之龴用
𢮿	扌千北
𤉚	火口欠
𪮣	扌十又扌斤
𣋩	日辛木口
𨑗	之上
𫲰	召子丿糸
𫴐	宀甘八冫甘
𣼳	氵土半丸
𧀨	艹巛圍乂巛
𥍒	目竹戊一口心
𪞧	冫亼卩一夕
𪞧	冫亼龴一夕
𡁚	口氵廿口夫
𡁚	口氵艹口夫
𧒌	虫足夂口
𪡊	口豸
䒜	艹牛
𪥌	宀人大
𠲓	口夂㐄
𫠹	上厶月匕匕
𬧺	車勹屮勹屮
𠸙	十口王廾
𬅽	冫卜了止
㥥	心日冂厶
𣜳	木艹風
𦀋	糸冫水
㭨	木牙阝
𱕷	口召儿召儿召儿
𠸂	口穴犬
𠱊	口亻士
𣳪	氵一口乂
𬆜	一夕匕石亠人人十
䊟	米廿巾人人
𨁼	足大十艹
𪧄	子瓜山鬼
𢩾	扌丸
𤤰	王𠂇巾
槺	木广尹⺍
𦵗	艹言十
𬰹	立日由
㟴	山鬼
𥆹	目山𠂊又
咾	口耂匕
𫥨	四大屮凵
𫺙	心刂一乚丨廾
𬨸	之㇕丿又皿
𠰷	口卜尸
𬄪	木女甘木
𬮌	文キ門
𢬣	手西
𨃰	足禾禾彐
𠞠	刀禾手丶
𩸰	魚子瓜
𢖱	心㇕丿
𫄑	糸食爪女
𫡇	八刀中
﨤	之𠂊又
𡮩	門十丿小丿
𬃂	木木二乂
𬃂	木木工㇕
𧋶	虫氵殳
𦝺	月羊大
鸜	目目隹鳥
𨶛	門工貝
𩭶	長彡氵由
𫊶	虫小兀
𣮇	口一大毛
𣮇	口乚大毛
𣮇	口乚廾毛
𫣽	亼口皿門一廾
𫢱	亻四十乚
𥯎	竹广卜口
𠴗	口木土
𤻬	疒辛木口
𫹣	行一火日小
鍄	金亠口小
𦓿	耒甘廾
𠍵	亻羊丶水
𡾬	山竹馬
𦢞	月魚日
𫑐	之木口户犬
𤹾	疒日𠂉母
慃	心八厶习习
𤓇	火王𠂊冂乂目夂
𫡾	亡心口月
𬳤	禾日匚艹𠂇口
𡪜	宀氵冖儿木
𡪜	宀氵冖八木
𩙕	日艹廾水風
𧞿	衤厂禾禾止
𠻛	口之牛口
𬠌	虫刀二阝
𪫚	氵土厶行彐キ
㙤	土虎爪丁
𥄬	目二乂
𥄬	目工㇕
𤉠	氵冖儿火
𧤭	巴𠂊用刀牛
𫩒	口巾
𥋲	目广禾禾彐
𨤔	尸毛爪木
𬥮	廿口夫八刀貝
𬥮	艹口夫八刀貝
𨙝	雨田之艮
摪	扌爿䏑寸
㥬	心亠八冖方
𤍑	火糸夂冫
𩸵	魚行一止
𨁮	足文口
𠹰	口貝丿之
𥆿	目十⺍丶
𪯝	廿月攵氵西
鈂	金冖儿
𫵫	尸婁扌匕匕
𨬉	金土隹
𢄩	巾廿儿冖巾
𬳖	八頁亻匕卩
𫁎	穴工子乚
𥈢	目羊大
𨃺	足糸冂人
𬷨	辰寸鳥
㩱	扌爪四艮寸
𬨙	辛弓刂
槩	艮旡木
𫽕	扌大八又
𠋦	亻甘木
𬐒	巴皮
𡾭	山广亠圍口禾
𤵢	疒丘
𢳥	扌之牛口
𪡝	口艹廾巳
𬋲	爪子乚工人人
𫣏	亻立申
𠴒	口亻亼卩
𠴒	口亻亼龴
𥟈	禾木口
𩺧	魚火至
𠪸	厂艹廿乚木
𣋇	日一勿文寸
𪘌	齒一口乂
𬣌	言甘木卯
𣦆	厂止一口乂
𦂁	糸八豕
𩸲	魚亻一口乂
𪰰	日土寸竹
𪟸	半亠八冖方
𢴾	扌非心
錩	金日日
𦡯	月之土羊
𡖼	立立夕夕
𠤧	匕扌日一止
𨒹	之一白
𧍅	亻一口乂虫
抺	扌二木
𠺕	口卯田
𫒂	𠂉小田土
𫒂	𠂊小田土
𫒂	竹八田土
𨰇	金亼口口人人欠
𫽹	扌由彐キ
𫜶	月亠口子攵
𠱶	口宀丁一
𫿿	八乂斤一火日小
𫠳	下亼冊
𣱿	氵人
𫴭	彐寸心
𤍌	士尸彐火
𪲣	甘木竹
𪿗	石尸匕
𬌱	犭門十丿
𧊋	虫申
𫻤	心文厂彡頁
夣	亠厶四冖夕
㹫	犭大弓
𧹥	土火木土
𬐾	甘匚儿氵欠皿
𬐾	甘匚八氵欠皿
𱻛	甘廾习习
𫡪	甘木乙
𠵴	口亼口卩
𥐇	矢一口䒑艮
𫼰	扌女口
𣷴	氵丰衤
𥑃	石亠卜
𦪏	舟之龴用
𠶂	口乂乂攵
𢱎	扌手一丰
𢱔	扌八刀皿
𢏠	弓氵工
𫁞	立竹
𪱅	日氵耂
㳉	氵月
𬐉	小彐白
𱔪	口文隹
𥅞	目弋工
𫡮	之米乙
㯖	木十四一心
𨏧	虎田皿車
𡏥	土扌斤口
𧐺	虫之龴用
𬥠	弋二貝𠂊又
𦀾	糸广木
𨅥	足非心
𪨠	尸婁亻半
𬌴	犭彐火
𨆟	足艹千日土
𦤮	之艮自犬
𡔖	土言糸糸攵
𪯊	凵攵竹
𬋙	火臼冂一口廾
𩸄	魚田木
𦙏	月山乙
𨔾	之耂
𪀐	鳥丿之
𬀺	巳日勿
䑅	月艹四冖夕
𬩢	之户冊立
𠸡	口氵丿皿
䕝	艹禾爪冂土
𧓮	王白石虫
𨃎	足刂又皿
𨰴	金日衣口口甘
𤃟	氵亠乚凵隹土
鑅	金火火冖木
𤭸	尸䒑廾瓦
𬞲	艹虎业一丂
𬞲	艹虎丘一丂
𡔍	土穴士四貝
𪿏	矢一口䒑亼冊
𫻐	工凡心一中彐
𫓟	金口口馬
哣	口一口䒑
𥃛	舟殳皿立日
捈	扌亼木
𪾯	目斤欠
𱢯	艹廿乚木日
𨤯	千日土冂一口
𬂸	木攵小丿
𦡋	月丿屮頁
𦡋	月一屮頁
𠃩	九人彡
𢭯	扌氵㇕大
𤻻	疒艹四戈人
𥵚	竹艹口丰力
𥵚	竹廿口丰力
𢜏	日月心
㗁	口口口一丂
𫑹	酉木人人
拞	扌丘
𣍊	日勹亡尸丶冫
𠓁	小兀羊丶水
𪢤	口矢丿大口冂口
𦂺	糸立日
𪽗	尸丶一由凵
𪽗	尸丶一田凵
𫼜	手卜口
𣼪	八氵戊一口
𨻮	阝宀一兀攵
𥌷	目宀丰四心
𪦸	子亠八
𣱶	氵卜
𧏰	虫耳冖儿
𪥑	大示㇕丿
𨃕	足亠幺田
𡮜	竹丿大小
𡃙	口艹四戈人
𦪻	舟宀艹見丶
𧓅	虫曲辰
𥸝	竹言夫夫貝
𬸼	尸匕鹿
𫋻	衤人二厶
𡅫	口車丿大口冂口
𡳵	尸婁艹丨日
𫀢	示山鬼
𠽮	口扌日一止
㨐	扌亻口木
㘨	土冂人
𣙯	木土隹
䶞	齒甘廾
漨	氵之夂丰
𪷹	立申氵丁口
𣙷	木艹犬廾
𪺓	爪尹亻丁
扲	扌亼㇕
𤸧	疒宀二日
𫅷	艹人木耂匕
𫜧	齒宀㇕皿丁
𤁖	氵衤田木
𬱎	丁頁亻立口
𫒥	金亡心
𢵬	手巳巳艹廾
𪰮	日牛巾刂
𫀅	示卜口
𠉜	亻尸毛
𨧣	金士冖几
𡀧	口冫十田衤
𤂫	氵口十艹貝
𣆮	日广土
𠽞	口氵日匕匕
𣞅	田木月䒑大
𨦙	金一夕刂
𢴛	扌斤扌十又
𠏟	亻亠圍口禾
𠻁	羊儿㇕一口
𥇽	爪子乚目
㶤	火夕
𬏥	疒臼卩
𢢂	心糸士口
𫽤	扌火卜尸
畱	一卯田
𤿤	竹皮
𦉱	四七
𥟊	禾二乂口
𥟊	禾工㇕口
𨂚	足八艹廾
𨰧	金宀龍
𪜘	石皮乙
燫	火广禾禾彐
𠘃	冫千日土力
𪯕	方攵亻𠂉匕
𣌁	日豕耂
𣔢	木亻夕夕
鸌	鳥艹隹又
𢬇	扌宀寸
𨫉	金日土寸
𪜯	亻口力
𦘧	尸毛彐キ田一
𫬎	舌亠乂凵冂厶
𱜗	口口匚コ
𱜗	口丿口匚コ
𥩯	立㇕丿子
𨄳	足艹甫
𬇋	户氏
𥊤	目行日一寸
𪱎	日生亼月刂
𪱎	日生亼月巛
𠽆	口言冂人
𬈉	氵土𠂆一口
㮠	木艹冖木
𠶙	口艹不
𱕫	口亠乚凵隹瓦
𥊢	十目小冂口
𠲠	口凵攵
𭉷	口示且
𣋛	日艹氵夂口
𥗍	石禾丿刀人水
𤹑	疒亻亼㇕心
㩒	扌木木示
䓡	艹矢口
𧿭	足日
𪡻	艹丨日十口
𢴓	扌不見
攑	扌臼一乚丨廾キ
𠿶	口氵隹十
𠴙	口扌巴
緓	糸艹冂大
𫏖	足爪一𠂇又
𨭒	金月穴工
㾑	疒亼口
𧀑	艹禾千日土
𩲥	鬼厶口
䱾	魚婁
𢬹	扌土土乚
𠸔	口艹亠巾
𢫛	扌王丶
𦡮	月立立日
𪁃	亻牛鳥
𨻬	阝自犬
𣞍	木四耂
𣃺	方八人口
𤒙	人彡亠口子丸火
𦄷	糸之龴用
𪺬	牛九日
𧁶	艹广四二八土
𡦂	宀子宀子
𧹋	亻弋貝爲
𫄁	糸艹日月
𫉕	艹人木力口
𬕺	竹立申竹
𲌬	鬼非
𥺹	米宀夕卩
𥹰	婁𠂊丶
聀	耳戈
𢱚	扌風
𠶣	口木攵
𢝳	氵艹廾心
𠴋	口扌九力
𫇈	臣亠人人十
𫻣	心鬼亠人人十
𡍘	土牛巾刂
𥨨	穴工工貝
𥚥	示乚禾刂
𫴶	广士口䒑寸士寸
𡀭	口臼田力
𫄃	糸亠口子攵
𩵝	魚十丿
㦖	心門心
𣨮	一夕爪工一
𣨮	一夕爪丿士
𪫶	亼㇕心竹
𠳙	厶口亻弋
𤮥	瓦匚口口口欠
𦙦	月心
𬗁	西米骨
𣑶	木示乚
𢟙	心金十
𤊡	火丰キ
𥏌	矢牛儿
𤢔	犭日勹亡欠
唭	口甘廾
𤛠	牛婁
𫃋	米金十
𤎕	火釆心
𦀨	糸刀二阝
𪝎	亻木亼卩
𪝎	亻木亼龴
𬚇	户习习氵㇕大
𡄐	口亠乚凵隹土
𥉰	目爪臼
𢴊	扌之豕
𥒥	石夕夕
𩄰	雨一夕刂火
𩼈	魚宀釆大
㖧	口氏日
𡁽	口木艹人木
𪡱	口耒毛
𡀩	口艹氵夂口
𥅲	目𠂉木
𠦯	半艮
𥭎	竹氵亡
𢩉	户艹廾
𫨯	土厶非心
槹	木白⺍十
𤮘	䏑又一口䒑瓦
𦛌	月彐キ
𣖠	木艹屮凵
𬌘	牙山手戈
𢴩	扌竹彐キ
䴈	宀米大鳥
𢥣	心竹門月
𨫪	金廿口夫
𨫪	金艹口夫
𪢜	口金甫
𡈈	圍千日土
𣻇	氵之艮
𩩇	亠厶儿骨
𣜶	木之日勹亡
𤎑	火囟儿夂
𤎑	火囟八夂
𬷶	亠圍口禾鳥
𫆜	䏑尸匕
𦛺	月口力刂
𥈱	目㇕丿又皿
𬯜	阝丁口艹冂人
䳱	予丿夂力鳥
𫼳	扌艹亡
𫤯	厶大彡八
𫡯	十日十月乙
猉	犭甘廾
𭉑	口阝艮
榡	木丰糸
鑨	金龍
𠁸	中中亠人人十
𫲳	一亻子尹口羊
𦭪	艹勹乂乚
𡋥	土士口
𡃍	口亼口口人人刂
𪃿	丁口丁口鳥
𫰮	女艹户
𤷿	疒穴犬
𦪂	舟行走
𦀪	糸亻白
𫅖	羊大扌口
𣠱	木竹旡旡日
𬓐	示乚厶口心
𠭤	口口厂又
𠭤	口口𠂆又
𠭤	口丿口厂又
𠭤	口丿口𠂆又
𣉷	日勿示乚
𣝀	木艹口丰力
𣝀	木廿口丰力
㦗	心木木示
𨭏	金月穴工
𬜉	舌田心
𱓱	十口衤刀
𧐸	虫用口彡
𬑑	目耂匕
𬇆	毛土土土兀
𩠳	八頁木隹
𬮙	門一力
𤡚	犭艮旡
𢵷	扌宀丰口刂
𫰸	女干卯
𠶚	口女丁口
𡁙	口心艮旡
𫮱	甘廾土𠂉㐄
㑫	亻亼㇕心
𪺛	八乂午凵
𪬙	心氵口月
𬏧	疒扌丸
𬚴	䏑匚巾
𡑱	土尹口羊
𦢡	尸至人人人月
𣠺	木竹亼口口人人
𫣰	亻申爪一𠂇又
𬥔	斤貝匕
𨔿	之豕十
𫬣	口口犬目小丿
𠯇	口巳
𠦹	十之豕
𠨪	𠂊厂卩土土土兀
𣿃	氵阝日冂厶
𬲠	食亼月刂心
𬲠	食亼月巛心
𠸕	口儿幺月
𫡽	亠八乂口口
𫡽	亠八乂口丿口
𣵯	口欠水
𥳂	竹田夂口
萫	艹禾日
𫸿	弓⺍甲一丿之
𫸿	弓八甲一丿之
𬉰	氵戈戈曲辰
𤯭	立立生
𫑓	之丿㠯田夂口
𤣡	犭四勹虫十目
𣼺	氵囟儿夂
𣼺	氵囟八夂
𢯏	扌行皮
𫑒	之木口亻立口
𩻐	魚囟又儿夂
𩻐	魚囟又八夂
𬠇	虫⺍廾
𥵗	竹立日欠
𥘶	示乚八刀
𧕃	虫召匕匕召儿丶
𥆄	目小兀
𧎠	虫儿幺月
𠀗	廿丿
𪽃	生丰キ
𠻤	口宀一由八
𢪯	扌大丶
炐	火丰
㡴	广立
𥯋	竹日月
𦬶	艹午
𥑭	石匚コ
𥊟	尸目刀丶心
𣡯	四土厶木幺幺戈人
㩢	扌艹四戈人
𣝉	扌业羊寸
𬲊	非心乙冫乙冫
𢱛	扌氵西
𣙹	木口日匕匕
熷	火八四日
熷	火八田日
堒	土日匕匕
𧉝	虫下乚
𩆐	雨亠圍口禾
𬦮	足耳
𣏾	木戈
𬀫	文日
𠺴	口艹夂口
𦝉	月广氏一
𦝉	月广氏丶
𪽡	巴釆田
𦩚	舟木攵
㒙	亻糸白巾
熑	火禾禾彐
𧏴	虫之丿㠯
𪮯	扌口耳竹
𫋙	虫弓厶虫
𢫗	手白
𥐨	石也
𠿱	口之八頁
𪺵	牛非心
𣞂	木竹彐冖巾
𧺁	宀釆田土火
𢯷	扌㐄口㐄
𫢧	亻文口
𩘄	風木攵
唫	口金
𡊱	土召
𣉴	日木至
𫊍	艹廿乚木山亼㇕
𤂧	氵艹之夂丰
𪂮	子瓜鳥
𪞻	亠乂凵口乚大
𨔉	之文丰
㵊	氵日耳又
㵊	氵冖二耳又
𥋟	目羊手戈
𥖐	石阝八豕
𡃎	口乂乂木木大
踭	足爪尹
踭	足𠂊尹
𡑴	土尸艹廾殳
𪨝	尸毛禾日
㐻	亻冂人
𦧃	尸婁艹隹臼
𨔌	之子瓜
𬟥	木口艹白⺍木
𪮽	手斤斤貝
𩹪	魚尸目
𫵇	尸目𠂉小
𫵇	尸目𠂊小
𫵇	尸目竹八
𩠠	八頁人二厶
㭲	木八人口
胋	月卜口
𬏗	釆田二欠
𬏗	釆田冫欠
𡳎	尸毛口口
𡳎	尸毛口丿口
𡆍	口方𠂉矢魚
怑	心半
𡬈	宀龍下
𢅄	四土厶𠂇巾
恑	心𠂊厂卩
𬟴	虫山
𱔩	口⺍甲一戈
𱔩	口八甲一戈
𪝯	亻立日一寸
𠬕	土厶衤甫
恄	心士口
𧜗	衤馬
𦤭	自犬一夕刂火
𫆃	凵攵耳
𡀂	口雨田
𬐼	氵欠皿土厶力
𬞺	婁艹丨日
𪟞	田力十丿
𣈝	日文丰
𩆢	雨田立日
𢏣	弓曲
𪽵	疒子瓜
磾	石口口甲一
𠉞	亼㇕尸匕
𠽁	口虎夂几
𡅑	口日冂厶頁
𡆘	口日幺幺火頁
𥢫	禾宀丰口刂
𠴉	口阝一兀
𧃋	艹食亼木
𠶁	口刂キ廾
鈘	金十又
𡴢	丿屮立立
𡴢	一屮立立
𤢿	犭石石石
𥽤	十又米田艹廾
㶥	火干
𫼠	手丶王
𦙥	月子乚
鑟	金士四貝
𥢐	禾自⺍十
𩅜	雨丶艮月
𨇀	足之中一㠯
𥀌	皮艹厶口
𬗝	糸龴用
𬛀	户月工
𫿸	人止亼木冫十
𦄵	糸釆心
𧦿	言一冂人
𪬔	心一夕𠂉木
𫨰	非心土厶
𦞑	月不皿
𫡱	又又二
𫾖	手一丰口貝
𧤥	𠂊用虎文
𧀏	艹金亠厶儿
𠧆	䒑艹廾亠人人十
𥷓	竹食爪女
𫳭	宀立申
𥿣	糸工丂
𧋀	虫⺍川
𠊫	亻勹日子
𤶼	疒艹亡
𫵄	艹冂大小
𬒩	石一日乂亠八冖方
𡓟	土木口攵一止
𬷸	鳥食爪女
𥐦	石巳
𥺖	米不口
𬡮	衤爲
搝	扌自犬
𬳠	禾火禾日
𣌹	曲不一
𦁢	糸長
挸	扌見
𬟣	艹氵木口刀貝
㗱	口隹木
𬁒	日予丿夂力
𢴍	扌宀一由八
𢗸	心冫十
𠲿	口木口
𩂀	雨干
洅	氵一冂土
䗀	虫土儿夂
䗀	虫土八夂
爉	火巛圍乂巛
𢊑	广廿丿用
𣘽	木小丿召儿
𦰠	艹八厶廾
𤵴	疒亻士
𢥶	心日冂厶鳥
𠻦	口囟儿夂
𠻦	口囟八夂
𬓟	亠乂凵冂厶禾夕夕
𱪁	氵艹一火日小
𥏍	矢夕口
𬕾	竹立申目
𡭬	小門十丿
𢯚	扌爪子乚
劕	斤斤貝刂
𪇩	金艮鳥
𨅽	足門木
㾯	疒田衤
𫏽	立申車
𪫊	一廾彡亻丰キ
𤜬	犭山
𬇉	氏一刀
𬇉	氏丶刀
捇	扌土火
㧶	扌身
𨓐	之口口
𨓐	之口丿口
𫴇	宀上小又丶水
𤋾	火立日
𠽙	口亻尸二コ又
𥈁	目之匕卩
𨀌	足口力
𫭵	土心彐丨
𣔨	木止月
𪃴	鳥爪丁口
𤍊	火丰糸
𨅮	足耂阝
𬊁	火冂土
𣜾	二木氵耂
𢖮	乙弋八
𡎣	土日召
𬁐	日月亼木
𣓋	木艹匕匕
𦣕	月西示風
𫷆	巾冂䒑山
𠸟	口不皿
𫱑	女石丿之
𱢱	日虎业一丂
𱢱	日虎业丂一
𱢱	日虎丘一丂
𱢱	日虎丘丂一
𥅃	目日一
𣌴	曲月
僘	亻小冂口攵
𣍀	曲口木
𧯵	一口䒑丰キ
𪽨	疒一夕
𡄰	羊䒑口亠人人十
𦗏	耳丶艮阝
𨫈	金广人人土
𠄧	巴二
𤃝	氵厂禾禾日
𢮪	扌八艹廾
鎶	金丁口丁口
𢇡	广一丂
𢇡	广丂一
𫦻	田力匕匕白
𬎹	生用口
𥸓	竹扌耳耳耳
𪄦	鳥艹人木
𦹴	艹糸丿之
𥭌	竹宀丿七
𡂑	口舟殳皿
𢵪	扌非文
蚽	虫不一
𣽀	氵一白一亻八
𧋷	虫巳心
𫕹	丰月生
𪂲	子瓜鳥
𬈽	氵爪子干八
𧥃	𠂊用阝八豕
𣒵	木巳攵
𪷴	氵土儿土丸火
𪷴	氵土八土丸火
𫵧	尸丶冫丰水
𫄎	糸尸婁
擼	扌魚日
𪝱	亻山隹竹
𧍌	虫氵召
𬞎	艹小丿召儿
𨏄	車一巛工耳
𢺒	扌魚丰キ
𪢍	口糸士口
𪝳	亻氵廿口夫
𪝳	亻氵艹口夫
𤞻	犭亼㇕口
帒	亻弋巾
𫅫	手一丰习习
𦼞	艹亼木田
𪝌	亻廿田
𫌌	衤山宀示
𩌂	革艹厶口
𬮷	門刂キ廾キ
𡮒	禾子乚小
𦚕	月甘
𠴛	口穴力
𨁭	足女小丿
𠸧	口心夂口
𩘬	風之艮
𬕳	竹馬竹
𦄠	言冂人糸
𡃻	口艹癶一口䒑
𥟉	禾禾几
𡎥	夕卜人人土
𪒷	牛疒甘四土火
𪒷	牛疒甘田土火
𢪳	手𠂊又
𫖚	立日宀一由八
𥫌	立石石石
𢴋	扌糸夂冫
𤺱	疒䏑犬火
𬅂	木十口亞心
𩪽	骨匕幺幺幺幺斤
惍	心金
𩸸	魚一尹女
𨰪	金釆四土半
𫋿	衤木攵
𤋶	火艹亼卩
𤋶	火艹亼龴
𣗼	木口貝
𫗌	大十艹乙冫
𫜈	𠂉母卜圍乂
𩄴	雨亻丰キ
𩺢	魚扌斤口
𡆄	口扌耳耳耳
𪭫	扌丁方
𡳃	尸毛人二厶
𦡢	月艹婁
𨮒	金艹四冖夕
𦷭	艹木人二厶
𫱸	女干丰水
𢀭	匚コ十日十月
𪢌	口門木四
𬉪	氵弓冫弓冫文寸
𧵆	貝斤
𧖃	虫虎一口冂八丁犬
𤐠	火示彑水
𠶟	口扌甲
𨀒	足𠂇巾
𨠣	酉一止
𨐺	辛曲辰
𠴌	口彐火
𢛨	心方人冫
撛	扌米夕㐄
𫱞	女文隹
𫡁	禾禾彐立立
𥻧	米禾禾彐
𪷪	氵一丂八刀貝
𪷪	氵丂一八刀貝
𦷫	艹氵𠂉母
𪤘	厶土甘木
𡍋	土大十艹
𪀄	卜口鳥
𫱬	女十口尸毛
𤃥	氵艹癶一口䒑
𡂵	口日亠口小彡
𫵭	尸婁咼
𡀿	口尸婁
𦴋	艹四冖又
𣅵	日心
𬖫	西米殳
𥛉	示乚手一丰
𪵅	一夕亼冊
𫋶	衤刀竹
𪪪	广廿又耳止
𥍍	目艹臣𠂉丶皿
𥍍	目艹臣𠂉一皿
𦙜	月厂卩
𡗶	一大上
𡄦	口臣𠂉口口口
𥺕	米扌巴
𤡁	犭廿巾人人
𣘾	木䒑户月
𩟬	食石石石
𬰉	雨田艮
𥕌	石車斤
𬊠	火亻工一几
𬊠	火亻丿士几
𢙕	心大八
𩚦	食七刀
𣓦	木氵丿之
𢚴	心刀丶心
𡒫	土木甘冂土
𩮿	長彡土半丸
槞	木立申
𬖅	竹立申习习
𤺮	疒户隹
𨆡	足艹廿乚木
𦠽	月爲
𠽗	口目艮
𱤎	木糸夂冫
𤃞	氵目廿巾人人
𥇈	目圍丿屮
𥇈	目圍一屮
𣊋	日干矢口
𡄏	口心戊一口心
𠵏	口匚亼口
𤜭	犭子
𣔟	木艹不
𤴶	疒士
𧍆	虫子瓜
𠠑	竹艮卩刂
𠸍	口羊大
𤽴	白耂子
𬯹	雨殳
𡡂	女羊丶水
𢱏	扌言丁
𧴋	豸西示
𢴚	扌匚艹𠂇口
𢟑	心車干
𫴋	宀立申下
㭁	木㇕丿
䟻	足亼木
𪩺	彐冖巾㇕大
𢗆	心一乂
𥓳	石行皮
𥰈	竹亻口王
𥰈	竹亻口亻土
𦞏	戊一女䏑
𤇧	火亻士
𦋂	四日寸
𫷗	𠂉㐄女又
𩏳	㐄口㐄白鬼
𨵣	刂キ廾門
𩘨	穴人口風
𬥣	八刀貝𠂊厂卩
𫴺	木乚小
𥒅	石一口乂
𥇶	目金
𣛤	田木木人人
㗳	口竹亼口
𡑪	土艹日勹亡
𪅪	亠口子阝鳥
𬍀	犭衣廿
烸	火𠂉母
𧏲	虫一夕刂火
𨅞	足竹亼口
𧋄	虫艹廾
𧻩	走耂匕
𤞺	犭牛口
𥱱	竹立卜口
𠰙	口干刂
嘇	口厶厶厶人彡
𦀚	糸口王
𦀚	糸口亻土
鐛	金日亠口小
𦢾	月山匕矢龴足
𫄼	午凵甘木
𡀮	口鳥衣
𢯨	扌艹一巾
𱔒	口言殳
𥄵	目木丶
𥄵	目十儿丶
𱤒	一木艹日大
𤅉	氵雨丶艮月
擛	扌艹廿乚木
𫇄	亠厶月一中冖口口甘衤
𩛸	食𠂉母
𫯕	辰寸夕卜
𠃣	乙小丿
𫇞	舟日四又
𫇞	舟冖二四又
𠗹	冫一夕刂火
𪩯	巳文厂生
𡮅	臼儿小
𫵦	尸十口方人冫
𬠺	虫羊䒑口宀丿七
𫤉	亻匕頁口口
𫤉	亻匕頁口丿口
𣈕	日木攵
舖	亼十口甫
𧋵	虫犭王
𣖡	木貝刂
𬑶	矢一口䒑艮
𠃅	厂四貝
𡝖	女刀丶心
𬛈	䏑十冂半
𬨬	之力尸匕
𠸨	口亻田土
𱠻	扌日甘衤
𣡤	木日衣口口甘
扗	扌土
𪽣	宀立申田
𦓇	耂匕匚口口口
𪵠	毛糸冂人
𨖧	毛之木口
𠳿	口尸毛
𢵋	扌耂阝
𠟸	言士口刂
𤞼	犭文口
𫯅	士尸女又弓
𪩦	匚コ木木
𫃫	糸石廾
𬧐	足糸田
姅	女半
𣋼	日魚日
𥆃	目女口
𤀐	氵艹亠八冖巾
𪝹	亻户冊女小丿
𦅯	糸竹土寸
𨗜	亼卩之木口
𨗜	亼龴之木口
𢬩	扌亻戈
𤆺	火子乚
𩽋	魚婁攵
𡃜	口石冖隹
𫲍	女艹日大日
𠾸	口走召
𢗉	心冂人
𪾟	目一乚一
𠝇	广勹巳刂
𢹤	扌走勹屮勹屮
𧜵	衤廿儿冖巾
𥌧	目魚日
𫫒	口彐キ日
𫮐	土八頁
𪲭	木丶阝一兀
𪲭	十儿丶阝一兀
𡮯	小丿之牛口
𢪏	扌日
𢖵	心女
𠣛	勹厶木
𨡈	酉爿士
𢤜	心八酉大阝
𪨈	尤口虫
𣩸	石亠人人十一夕匕
𣼸	氵頁戈
撴	扌亠口子攵
𧏱	虫冂大皿
𠊙	亻宀且
𢙽	𠂉母心
㨂	扌木日
𥄰	目亻二
䲼	生鳥
𧿬	足丿屮
𧿬	足一屮
𫫛	口艹酉
𢄝	白巾勹巳
𡘮	一木手丶
𥾽	糸亠卜
𱻢	立申习习
𱐩	𠂉力
萡	艹氵白
𫰕	女亻㇕丿
𪡎	口力亼卩
𪡎	口力亼龴
㭬	木豕
𪭡	扌亻十
𪭱	扌冫㇕大
𧜹	衤犭丰月
𥐆	矢一口䒑半
𫥪	亠乂凵刂キ廾
𢬮	扌戊一
𡂆	口木卯田
𨤼	千日土日衣口口甘
𩻓	魚艹亼木
𠓨	勹巳人
𫣱	亻户冊丿之
𪑑	四土火口亼㇕
𣔣	口木王丶
𠹲	口氵耂
𣌆	日言耂
𫃮	糸行丶王
㘈	口匕矢龴足
鈬	金尸丶
𦢶	月禾几頁
𫠴	丘人二厶
𬯽	雨氵幺㇕
𥚄	示乚一口乂
𠋺	亻又冫虫
𠋺	亻又丶虫
𨠳	酉亠凵人
𫠪	厶人下
𨻫	阝立申
𠽍	口氵爪工一
𠽍	口氵爪丿士
㥋	亻衣心
𪠝	土厶尸匕
𬖼	米且疒卜了
𫫴	口糸亠厶儿
𪩭	巴木人人
䙛	衤衣八厶
𡗄	禾禾彐夕夕
𤋽	火田亻八
𧁵	艹扌𠂉廿廿火
𧝦	厂止一夕刂衣
𫉡	艹月亠人人十
𡨧	宀亠人人十
𬷲	走戈乚鳥
囻	圍巳七
𠾀	口亠厶月攵
𢣅	心艹氵夂口
䒹	艹耒
𨆷	足业羊寸
𧻚	走二日
𪽝	四土厶由
𪿀	目宀日冂厶
嚈	口厂日月犬
𣩦	一夕土土土兀
𪹚	火亠八冖方
𨢇	酉卯田
𨂖	足氵立
𬏎	釆田干
𬥆	召豕丰キ
𥬋	竹八丂
焒	火口口
焒	火口丿口
檂	木曲辰
𥉹	目田糸
𢩣	户方艹之夂丰
𦂿	糸十冖子力
𪐾	四土火亻士
𪐾	田土火亻士
𫛎	竹丿大鳥
䤲	金土火
䇛	竹止
𫄌	糸足爪女
𤳱	田广廿由八
𫬑	召爲
𪽹	疒阝日冂厶
𠽏	口阝𠂊臼
𠒦	小兀口口
𦰟	艹阝一兀
𡦫	子斤斤貝
𩮭	長彡丿㠯一巾
𡳳	尸毛亼四日
𫥥	亠乂凵尸丶冫
𠓩	耒人
𤼔	疒馬亼㇕心
𧝧	衤⺍甲一戈
𧝧	衤八甲一戈
𥐧	石廾
𠿀	口禾小月
𣴚	氵力力力
𱜜	亻一火日小匚コ
𪪇	干八亠八冖方
埈	土厶八夂
𡚢	大艹魚禾
𫷏	糸氏巾
𢣧	心虎业一丂
𢣧	心虎业丂一
𢣧	心虎丘一丂
𢣧	心虎丘丂一
𪶭	氵一夕刂火
𬁥	耂丂曲
𥋴	目木木示
枮	木卜口
𦧘	䏑舌
𠄯	一丂木一
𠄯	丂一木一
𬺘	立申山
𬦿	足亻言
𨁍	足見
𬑛	目亼㇕心
𩿚	鳥冫十
𠲧	口弋工
𪧻	身寸半
𧄵	艹犭巛圍乂巛
𬐌	白扌皮
𩼀	魚圍㐄口㐄
𬩧	之咼耒
𢫡	扌㇕丿子
𬅀	木辛木口
𤵕	疒八丂
蝩	虫千日土
𢀮	亠圍口禾匚コ
㖼	口甘木
𡏠	土月勹乂凵
𢆠	木人人干八
𣖟	木言十
𪷩	氵一白木木
𥄮	目工一
𥄮	目丿士
𥜤	示乚貝戈戈
𦲞	艹厶大彡
㧺	扌水日
𫭔	圍王丶艹𠂇口
𪴾	四言止
𧯅	八人口禾日
㹯	犭亻木
𫡵	二乂十冂半
𫡵	工㇕十冂半
𧲫	豸𠂊又
嚉	口业羊寸
𫁅	卜貝禾厶
𦤯	自犬甘匚儿力
𦤯	自犬甘匚八力
喯	口大十艹
𣑳	木耒
𧂁	艹口口甲一戈
𢪉	扌弓丨
𤣚	犭曲一口䒑𠂊巴
㛪	女大申
𠶎	口行皮
𣻾	氵日土小丿
澟	氵亠圍口禾
𦼥	艹氵耂
𩭆	長彡亼口
𫡎	石石石中中
𥾗	糸小
𥽄	米糸亠口儿
𢵌	扌阝八豕
𤳸	由四厶月匕匕
𫢚	竹一衤
𠺯	口貝亡
𧞴	衣言用口
𨄿	足糸夂冫
𠡧	文口力
𩽊	魚石石石
𪢖	口禾𠂊彐心
𬴓	竹馬骨
𣏿	木一大
𠺙	口之艮
𫷰	广木厂又
𫷰	广木𠂆又
𦀺	糸車
𬄹	木厂四貝
𡊲	土丶王
𪺨	牙亠人人十
𱸉	竹亠儿⺍
𫡛	大弓之
𢶢	扌丿四豕
𫠽	上心丰月
𥓷	石广彐人
㗑	口手一丰
𪛅	足夂口龜
𦟽	月宀弋八山
𪨖	尸毛甲
𢪥	手勿
𫚳	鳥卜口
𫅲	习习竹立申
揬	扌穴犬
𦃾	糸一夕刂火
𣫕	田尸艹廾殳
𥳓	竹禾小月
𬏚	疒一
𤎛	火氵爪工一
𤎛	火氵爪丿士
𣺾	氵艹女口
𢉾	广幺幺山
㮀	木丂⺍凵
㮀	木了⺍凵
𨀕	足匚王
䮴	馬癶一口䒑
𠽒	口丁頁
𤮃	瓦冂大皿
𠆍	亠月十目廾
𠆍	亠月匕目廾
𢟘	心耳戈
𫠧	午下
鋥	金口王
鋥	金口亻土
𣆐	日卜尸
𣐅	木工一
𣐅	木丿士
𡅳	口艹口口隹力
𢹇	扌四土火犬
𢹇	扌田土火犬
𦏄	羊大扌日一
𥵘	竹日一亻一夕刂
𦔙	耒艮旡
綡	糸亠口小
𧋂	虫氵丁一
𠏲	亻四耂
𢦂	心艹門木四
𢦂	心艹門木日
𣐴	木亻士
𡧲	宀丁中
𩂠	雨亻弋
𬩋	之木丶言
𬩋	之十儿丶言
𠱅	口又土
𠸽	口之尸匕
𫠼	上扌足
𫅯	习习之木口
𢠤	心弓⺍甲一
𢠤	心弓八甲一
𧅬	艹田木大八虫
醝	酉羊工
𠂫	亠卜㇕丿
𪯰	亼木冫十隹又
𠢑	辰寸力
𢯐	扌女十口
𫣢	亻大八虫
𢭰	扌木土
𤷄	疒半卩
𬏸	疒冖一兀寸
㖑	口戈廾
𠣂	言木四力
𠣂	言木日力
𦹷	艹土立口
𥐔	矢一口䒑門口
𪁎	小月鳥
𠁻	中中石石石
𨆤	足尹口羊
𠡛	圍大力
𦂈	糸由月
𢵴	扌止彐冖巾
𬏓	釆田巴
𤯑	甘匚儿亠圍口禾
𤯑	甘匚八亠圍口禾
𨋤	車卜尸
𩬑	長彡卜口
㯷	木亻业半大
𬚌	甘廾耂匕
𪰇	日竹
䉭	竹巛圍乂巛
𢲯	扌氵大人人
𦏓	尹口羊木一
𢇉	幺㇕文寸
𠟥	小大舌刂
𤏥	火亻冖隹
𥽢	米乂乂木木大
𠰘	口皿
𪅬	亻匚日女鳥
𫠮	至下
𬡞	艹衤巴
𦛿	月艹亡
𥑂	石十又
𤳨	由示彑水
𨃝	足行走
𨁩	足扌巴
𡾵	山鬼亻立
𩱻	鬼卜
𨁷	足十目
𡅊	口十艹貝米
𬂍	月刂キ廾キ
𫸏	广廿一由八冖日亠八
𫯓	木人人夕夕
𢢯	心山鬼
𪳂	木八頁
𪾀	白戈口一
𢱖	扌甘木
𨀐	足夂冫
𤠴	犭阝宀一兀
𨨅	金戈口一
𠻆	口阝車
𪱚	月上
𢁯	巾日
𬟃	艹业冖一豕
𨃑	足扌儿⺍
𤈠	火彐キ
𬃑	木羊川
𢤞	心臣又貝
𫕪	雨氵一夕刂
𣡝	不皿白幺幺木
𧿨	足厂又
𧿨	足𠂆又
掑	扌甘廾
𢕸	行米夕㐄
𱳚	目言艹日大
𦀐	糸广土
𧺀	土火宀釆田
𠴍	口刀丶心
㦨	心門木四
㦨	心門木日
𦘱	月卜
𢶿	扌之𠂆十目
𣙬	西木匚コ
𠴜	口扌十又
𫗷	八頁口木
捠	扌斤廾
𤁠	氵之爪午凵
𤁠	氵之䏑午凵
𢚸	王廾心
𫴯	貝刂寸
㗀	口幺幺山
𫪣	𠂆一口亻士
𨙍	之矢丿大口冂口
𤝑	犭丿之
𥅘	目𠂉小
𥅘	目𠂊小
𥅘	目竹八
𨊌	身米夕㐄
抈	扌月
𡍝	土艹冂人
𢲭	扌酉巳
𩵜	魚竹
𥙩	示乚厶人
𧀐	艹王鬼
𣷮	氵石廾
𦀏	糸凵攵
㖅	口戊一
𦎡	羊大生
𡂎	口糸彑水
𥋓	目日亠口小
鑡	金齒
𢷹	扌广田土八土
𧛋	衤亼㇕心
𡞕	女夂田
𨖙	之四亻
𫤢	牛儿立丿生
𧏯	虫辰寸
𩶝	魚一止
攞	扌四糸隹
𩺨	魚亻丰キ
𩴬	四貝鬼
𬚯	月士
𪮩	手米且
𪹎	火冖一兀彡
𡳤	尸丶耂阝
𢣄	心之咼
𤓩	火言糸糸攵
𥾾	糸亻卜
𣋰	日艹廾水几二
𥖔	石木戈戈
𣍋	亼四日下
𣾿	氵口田衤
𫏢	足丿皿豕
𫌐	衤走戈乚
𪻋	犭广士口䒑寸
𤳷	四厶月匕匕由
𥐉	艮矢一口䒑
𬩯	之木口鳥
㮛	木日一止
𦁀	糸貝
𡏢	土馬
𤯰	生广氏一
𤯰	生广氏丶
𥇻	目宀由
㓠	卜口刂
𥶇	竹魚日
𤣄	犭鹿火
𫩉	示乚耳又
𤹘	疒辰寸
𥈳	目穴犬
𢹫	丰刀手宀弋八山
𣞽	木癶一口䒑阝
𬛯	自犬立日
𤆹	火牙
𧐾	虫立口阝
𩄔	雨扌㇕水一
𥓉	石戊㇕
𩅚	雨土隹
𬁌	氏日䒑亡
𫯳	千日土夫
𠉱	亻户方
𫙖	魚尸匕
䟬	足丘
𠔭	八厶厶厶人彡
𦼝	艹心巛囟
𪻊	犭耂艮
𣻗	氵禾夕夕
㷚	火亠口冖丁
𫠻	不亻言
𢯕	扌宀且
𢺔	扌宀王𠂉小貝
𢺔	扌宀王𠂊小貝
𢺔	扌宀王竹八貝
𨔍	之四十乚
𠖘	冖糸冂人
𡹞	山亠口小
𬇑	气木卜
𢫌	扌亻也
𣚮	扌立日木
𫗗	食尸目
𬯄	阝𠂇工土
𠏥	亻山一口䒑大
𢠉	心亻日冂厶
𬪄	刀二阝竹
𬜆	舌丿之
𫽦	扌氵九木
𡮥	小門十丿
𰛻	氵彐火
𧶭	貝大十艹
𡲤	尸毛且
𪠗	厂日子厶口
𨨪	金牛巾刂
𪶵	氵禾手丶
𣠓	木竹西示
𢣂	心羊手戈
𡗋	亠圍口禾夕夕
𦂼	糸甘匚儿
𦂼	糸甘匚八
𡨺	宀丁宀寸
𤛞	牛門十丿
𩺱	魚匚艹𠂇口
彣	文彡
𠏠	亻足土土
𪨁	爪子小
𫷜	𠂉㐄十冂半
𠾛	口廿由八
𨦥	金氵也
𧴤	貝卜
𡔑	土臣𠂉丶四見
𡔑	土臣𠂉一四見
𩁶	雨乙
𥣒	禾亼月刂心
𥣒	禾亼月巛心
𡆈	口方𠂉矢鳥
𪖭	自田廾日一寸
𧃶	艹犭艹冖一豕
𢴘	扌犭丰月
𪲽	乂木扌斤
𨅐	𠂉廿廿火足
𣳮	氵口口
𣳮	氵口丿口
𥴙	竹木卜日十
𦪦	舟小冖口手
𬐆	白丿之
𡆁	口食土土土兀
𣺽	氵四土厶
𢯛	扌氵立
𡪻	宀日女十口
𡃽	口亻雨而
𬡯	衤大八虫
𫶜	山亠口冂口竹
楴	木亠八冖巾
𨇜	耂見足
𫂷	米乂十
𧜻	千日土力衣
搈	扌穴人口
𫏾	車田夂口
𬧒	足口口口一丂
𬧒	足口口口丂一
𬋱	爲竹
傦	亻骨
𤵖	疒日
𣈒	日甘廾
𡤓	女厶口四貝
𫸌	广廿一由八士尸
𠽂	口弓⺍甲一
𠽂	口弓八甲一
𢢈	心宀甘八冫
𤏣	火言斤丶
𢷵	扌𠂉廿廿夕㐄
㫵	日非
𢌎	广艹丿㠯辛子
𩆏	雨艹廿乚木
𫗺	八頁士方攵
𫗺	八頁土方攵
𫗺	八頁丰力攵
𬚁	羊䒑口爪臼
𠱉	口人彡
𢸝	扌氵夫夫日
𤊥	火土儿夂
𤊥	火土八夂
𡑵	土艹風
𣋽	日亼口口人人刂
𬛃	䏑耂
𪪫	廿口夫广車
𪪫	艹口夫广車
𤎐	火匚艹𠂇口
𠑖	亻立山鬼
𥱪	竹骨
撎	扌士冖一口䒑
𡓇	土魚日
𠺚	口王刂王
摼	扌臣又土
𢫖	扌木丶
𢫖	扌十儿丶
𣓿	木艹冖力
𬉙	氵立艹田
𥘑	示寸
䖳	虫宀丿七
𢫃	扌口凵
𩯀	長彡之木口
𫶴	羊工口口
𫶴	羊工口丿口
𢗇	心夕
𢴒	扌亠口了火
唻	口木人人
𦄴	糸齊示
㯲	木木木示
𦄀	糸馬
𣭻	足毛
𥺽	米亼冊
𫍍	言甘木勹丶
𥯈	竹木厂又
𥯈	竹木𠂆又
𨯹	金竹馬
𠴔	口口王
𠴔	口口亻土
𨆓	足人亠乂凵冂厶
𡓏	土米夕㐄阝
𠯽	口止
𨬊	金耂子攵
𣔻	木穴犬
摱	扌日四又
摱	扌冖二四又
倈	亻木人人
𠿹	口亻工一貝
𠿹	口亻丿士貝
𠯹	口亻㇕丿
𩹩	魚艹亠巾
𦟺	月扌土土卜
𥝥	禾𠂊又
𨄉	足立丿生
𤷲	疒爿木
炵	火夂冫
𢄃	巾氵𠂆亻
𪞠	冫亼卩了
𪞠	冫亼龴了
𫰇	女厶
𱡅	扌四土火土
𱡅	扌田土火土
𪹪	火亞心
𥋹	日一寸目巳七
𨃍	足穴犬
𩁱	隹木臣𠂉丶皿
𩁱	隹木臣𠂉一皿
𡂃	口二厶鬼
𣉵	日勹屮勹屮
𬏖	田艹廾王廾
䋘	糸耒
𫁛	穴牙亼冊
𪫵	王廾心
𥖕	口口石皮
𥖕	口丿口石皮
獜	犭米夕㐄
𫧾	卯丶丶爿士
𪷥	氵立土儿夂
𪷥	氵立土八夂
𪽽	白丘
𠡺	土厶阝力
𪽲	疒一冂人大
𬑾	石一大
𣎣	月白方攵
𣞎	木艹刂𠂉丶皿
㶩	火冖儿
𡂰	口米夕㐄阝
𥗌	石虎豕刂
𢙭	小大心
𥯉	竹女石
䠣	足巳巳艹廾
𢜗	心丰キ
𧴱	貝女
𢥅	心金白巾
𠅒	亡一木
𠼶	口土火卩又
𧾌	走巳巳艹廾
𬋫	爪一𠂇又竹
䇠	竹丶王
𫔸	刂キ廾キ門
𪡷	口阝亼木
𠸛	夕口牛儿
𦈂	糸食土土土兀
𣻈	氵亻丰キ
𤼞	疒臼丨又亠凵人
閧	門艹廾
𡆖	口艹酉隹火
𢨵	户午
𠇖	亻丿之
𣘉	木犭亼㇕口
𫬠	口臣𠂉丶見
𫬠	口臣𠂉一見
𢭴	扌心㇕大
𢱗	扌艹十口
𣋀	宀牛日生
𫅝	羊大月日一
𧜐	衤乚厶口心
𠴥	口氵冖儿
鬭	鬥卯亞斤
𨆾	足宀䏑又示
釟	金八
𥩇	穴心戊一口心
𨋣	車一冂人
㫧	日米
𪇐	鳥䒑屮月大
𬡟	衤艹風
𡓢	火𠂊臼人人土
𪬎	𠂊彐心巴
𢱙	扌子亠凵人
𠮙	口乙
𦲻	艹爪工一
𦲻	艹爪丿士
𦾤	艹亼月刂心
𦾤	艹亼月巛心
𢸜	扌米夕㐄阝
㘋	口臣又貝
𬧖	足之八頁
覵	門月見
𬏪	疒宀女
𩸘	魚宀㠯
𬄓	木衣八口
𡒭	土亻一火日小
𩄵	雨糸冂人
𠬠	八又
𫣞	亻虎业
𫣞	亻虎丘
𫶯	羊工女
𨅃	足山宀示
𨃈	足艹廾巳
𡅪	口厂白小頁
𠰏	口丿之
𤋸	火丰刀大
𧷝	口欠口貝
𫺈	心氵女
𢹣	扌矢丿大口冂口
𬪾	千日土厂卩
𠵱	口亻衣
𫈥	艹木丁口
𨀼	足耂匕
𤂷	氵門方人冫
𦎬	羊日生
𨲖	日冂厶長
𪡔	口四十乚
𥬮	竹氵工
𬣎	言亼冊人王
𫵉	丶艮阝小大
𬩔	之日冂厶𠂊又
𩺣	魚日儿⺍
𠴕	口女小丿
𪪀	丿㠯一巾止匕木
𠯿	口亠八
𢵽	扌足木口
𱫳	戈烏
𠽐	口魚
𫊬	虫冂大
囄	口亠乂凵冂厶隹
𢟟	心一白戈
𤿍	皮丁一
𪁅	𠂊巴鳥
𠓑	小兀魚日
𪪳	八厶廾
𦼃	艹人户口刂
𨣤	酉木木示
㗞	口石皮
𬂽	木木二乂
𬂽	木木工㇕
𫤤	小兀人户口刂
𠮩	口了
洡	氵耒
𧄊	艹日十廿口夫
𧄊	艹日十艹口夫
𫷙	干八齊
𥓄	石田土
𦟸	月氵亠亻夂丶
𬚣	耳止亻匕卩
𨀰	足冫水
𡏯	土貝攵
𧢟	齒見
𦛉	月口巾
𬟠	華一曲日
𫋐	虫工貝
阥	阝水
𦄁	糸之艮
𢠣	心阝木日
𤳄	由四土厶
𨡊	酉口力刂
䁾	目艹四戈人
𩂟	雨戊
𣾽	氵毛毛毛
𣿇	氵禾亼㇕心
𧀒	艹女木口攵
䏾	月丰キ
𡖱	夕夕亻半
𬊭	火日业
㘇	口火火冖木
𣲦	水小丿
𦝃	月木木
𩷕	魚丶艮
𫈈	艹亻𠂇口
𦡲	月宀心皿丁
𩟡	食业羊寸
濓	氵立丿彐刂八
𠶒	口心日一
𬦸	足日匕匕
垹	土丰阝
𨛦	尹口口巴
𧤸	𠂊用囟又儿夂
𧤸	𠂊用囟又八夂
𤯿	广氏一立丿生
𤯿	广氏丶立丿生
𠎬	亻竹土寸
𩵃	鬼齊示
𫯧	大亻𠂉匕
𩷛	魚𠂊用
𧣠	𠂊用一止
𪲾	木爪丁口
塸	土匚口口口
𡜵	女甫
嗘	口爪幺大
𠸺	口之䒑屮
𤁙	扌八氵戊一口
嘅	口艮旡
𢜠	心日月
𥽪	米竹馬
薟	艹亼口口人人
𪹂	彐火又土
𢤡	心石石石
𪼀	王亠八冖巾
𬖵	米宀弋八山
㩡	扌石石石
𪤤	土示彐水
𨮊	金甘匚儿冫十
𨮊	金甘匚八冫十
𧋿	虫心㇕大
𫆥	户月亠儿
𠺭	口亻丰キ
𠳒	口一大上
𢠐	心魚
㖪	口戈口一
𪃙	耂鳥
恾	心艹亡
𦒹	耂匕亠八
啿	口甘匚儿
啿	口甘匚八
𨒸	之一亻子
𥾿	糸午
𡁺	口氵衣八厶
𤉜	火广木
噷	口立日欠
𤓛	火小兀习习隹
𤋹	火木十口
𪬳	亡心口貝
𬏇	田王廾
㨢	扌厶月匕匕
𥐏	矢一口䒑尸㇕口
𢆪	土半土田土
𬚸	舌䏑
𨄂	足丶艮阝
𧏳	虫扌甫
氽	人水
𡲫	尸毛𠂇巾
𠼾	口山宀示
𤑭	火石石石
𢟔	心之艮
𥼳	米亞心
𠲵	口土厶力
𫉚	艹言户
𤍄	火示且
𬏠	疒幺㇕
𩙌	几二之亼月刂
𩙌	几二之亼月巛
𪨣	山𠂉乙
𣇝	日冫亼卩
𣇝	日冫亼龴
𣾾	氵小丿立口
𧻪	走戈𠂇
𫥸	刀卜口
𣛩	木竹人王
𥌸	目門𠂊臼
𧛇	衤長
𪷮	氵牛儿亼十口
𫾕	扌艹日大心
𠄽	二扌非
𨇣	足臣𠂉丶見
𨇣	足臣𠂉一見
𤶄	疒亻工一
𤶄	疒亻丿士
𡃑	口言丰月
潷	氵竹彐キ
𦂻	糸行彐キ
𪒽	四土火石石石
𪒽	田土火石石石
𬉽	火山乙
𠡏	生力
𬒏	石山巴
哯	口見
𪀎	口乂鳥
𠻂	口山言
𢯘	扌艹亻匕
𬛏	北月亠乂凵
𠤆	勿氵耂
㖔	口一大口
𩷊	魚凵攵
𥺎	米且八
𥇹	目日一寸
𪶊	氵文寸
𢝀	心穴犬
溩	氵烏
𫾗	扌言亼冊
𫊩	虫𠂊又
𥩉	穴牙雨田
𦅲	糸走戈乚
𠺵	口耳戈
𫇐	至了口又一
𫇐	至丂口又一
𡏘	土頁夂
𠶘	丁口一夕刂
𢀥	匚コ丰阝
䤠	金止
𥸿	巴米
䖡	虫彐丨
𡀣	口艹口丰力
𡀣	口廿口丰力
𠴝	口氵王
𩺌	魚廿乚冖巾
𢺖	扌日一口口甘衤
𩼤	魚亠圍口禾
𦢴	月八口儿穴犬
㫾	日小冂口
𠻃	口車干
𬳦	禾日亼㇕貝
𠹛	口山一口䒑
𠖾	冫一木
𬞢	艹爪丁口欠
𬈗	氵扌爪女
𦼟	艹糸亠厶儿
𪮴	扌尸婁
𡮶	千日土小冂口
䲨	工鳥
𣋝	日口口口木
𣲹	氵冂土
𣗒	木金十
𥠯	禾艹卜口
㐱	人彡
𫿕	方攵艹几二
𦚭	月虫
𫇌	自犬大申
𡃐	口巾口口甲一
𣩁	一夕匕扌斤
嗂	口爪午凵
嗂	口䏑午凵
𡀶	口氵厂白小
𠿸	口艹口口一丂
𠿸	口艹口口丂一
𡺦	山㇕丿又皿
𩇢	丰月小冖口手
𤯊	艹人木甘
𥗹	石艹魚禾
忼	心亠几
𬐸	虎田皿竹
𫥧	屮凵四十乚
𬡶	衤四土火土
𬡶	衤田土火土
𠞹	釆心刂
𪴹	一止氵土厶
𦀿	糸尸毛
𥽌	米之八頁
𠰍	口丶王
𫤄	亻一口乂扌隹
𠢬	𠂉廿廿火力
𦆺	糸亼卩頁
𦆺	糸亼龴頁
鬂	長彡斤廾
絩	糸儿⺍
𫣃	亼卩宀女
𫣃	亼龴宀女
𣉲	日隹又
𤺶	疒馬又
𬞊	艹宀㇕皿丁
檺	木亠口冖豕
呡	口巳七
𠸠	口大八口
𪴞	白⺍木日月
𱿜	虫心
𬓰	禾亠亻夂丶
萾	艹㇕丿又皿
𢭽	扌氵冖儿
𤚦	牛十口木
𣟫	木艹門月
𱤕	木艹大十艹
𬚀	尹口羊非
𬣈	言亻廿丿用
𪪉	土半𠂉母攵
𣛟	木小冖口手
𧚠	王廾衣
𬱻	立几二
𡡦	女阝八豕
𪁂	大八鳥
𨧟	金刀丶心
䃄	石亠口小
𤊨	火戈口一
𤪊	王金亼卩
𤪊	王金亼龴
𫼌	户艹廾
𩍢	革雨田
𤈟	女口火
𫏊	足亻工一
𫏊	足亻丿士
𫰴	女宀牛
㓭	日勹亡刂
𣉹	日行亼木
𧡊	亻木一見
𫑯	丶艮阝白大十
挗	扌大弓
𡴯	山乙
𫇿	艹木口
𡁛	口女木口攵
𬴭	長彡犭虫
𣠗	木丿㠯止彐冖巾
𥙓	示乚月
𫘵	亠口冂口了
𠼕	口扌非
𫌢	見十冂半
𨙌	竹艮卩之一兀
𬹏	广木木文口
𬹏	广十儿十儿文口
𫡉	宀子中
𪶏	氵土厶竹
𬪼	千日土夕
𩀳	王廾𠂇厶隹
𫿇	方攵且
𫽻	扌刂キ廾キ
𪥛	立申大
緍	糸氏日
𣄖	方𠂉風
𬃴	木木一白
蕯	艹阝夂一生
𧶬	貝女日一
葇	艹予丿木
㗜	口亠幺田
𣠲	木示曲一口䒑
𣛥	木非心
𪖬	𠂉母自田廾
𡄧	口言甘冂土
𨀺	足一夕刂
𨁘	扌止足
𬘋	糸斤斤貝
𬨠	之丿廾
𥣽	禾隹中中
𡴉	丿屮凡
𡴉	一屮凡
枛	木爪
𡤊	女工一氵耂
𡤊	女丿士氵耂
𠴚	口亻𠂉匕
𠶃	口王一兀
𬡴	衤糸白巾
𫗂	几二之艮
𫨩	厶口匕匕
㨃	扌亠口子
𥺻	米金
𬩱	之丿㠯土土土兀
𬇫	氵扌巴
𢳝	扌革力
𦷩	艹石丿之
𬑸	矢一口䒑穴犬
𠜭	刀扌冖儿
𬩩	之𠂊又日四又
𬩩	之𠂊又冖二四又
𠄳	二土厶力
𨸾	阝北
𬕼	竹矢口亡
𫉎	艹木二乂口
𫉎	艹木工㇕口
爙	火衣口口甘
𤇥	火立
𦢄	月非衣
𡃺	口之土土土兀
𥽔	米糸白巾
𧼌	豸走
𧊎	虫戈乚
𩴚	鬼齊示
𫪗	口戈止
𧖰	丿皿卯
慤	士冖几殳心
秱	禾冂一口
𬤴	八人口頁
𬎣	瓜丿之
𫪏	口氵勿
𬏌	由走巳
𬗻	糸工刂又皿
𧙽	衤虫
𠗰	冫王人彡
嗙	口亠八冖方
𫴬	文寸竹
𫯵	大立口阝
㯊	木一止一乚火
𦀻	糸巳攵
㑏	亻宀寸
𩵞	魚千
𫥩	亠乂凵二乂口
𫥩	亠乂凵工㇕口
𢺛	扌門口口甲一
𤵳	疒木一
䀲	目𠂉母
𨇍	足夫夫車
𢽙	尸毛攵
𢪲	扌匕匕
𱑛	爿士卯丶丶
𪂰	鳥广氏一
𪂰	鳥广氏丶
𬐎	白亠人人十
𪨜	尸丶行木丶
𪨜	尸丶行十儿丶
𠽈	口氵戈戈
𠀧	巴三
箤	竹亠人人十
𡔒	土日衣口口甘
𫠯	王廾下
𪞷	屮凵廾
𡂌	口十目廾小丿
𡂌	口匕目廾小丿
𫎰	土火糸田
𠗣	冫亼冊
𬹸	齒米夕㐄
𤍃	火氵𠂉母
𡮽	小大之𠂆十目
𦄓	糸白卯儿
𪝮	亻言牛儿
𬩄	㇕丿之八豕
𪢆	口之耂
𦙤	月毛
𧋇	虫厂止
𣈞	日穴工
𨉟	身亼口卩
𤎏	火皿亻
𥟌	禾艹凡
𨄑	足勹一口田
𩪵	骨婁攵
𢶥	扌氵隹十
𤞑	犭圍口
𨱽	長申丿
𤞩	犭且力
𠔦	口力斤廾
𢷣	扌臼一乚丨廾
𫧬	午言耂
𧓏	虫耳又亻
𤰁	臼一乚丨廾キ生
𥮇	竹丰阝
𪞅	亠厶儿艹厶口
𪳔	𠂉木亼冊
𨑮	之亻十
𠻪	口氵火火
𥊜	目言㇕大
𧵟	貝瓜
𠠚	齒刂
𫦇	八刀氵下乚
洏	氵而
𫃚	糸卜
𡂙	口之尸水牛
𢭵	扌女又力
𪶚	氵二木心
𠖝	冖一兀彡亼卩
𠖝	冖一兀彡亼龴
𤻒	疒石亠人人十
𨃻	足一夕刂火
𤋼	火艹十口
𣻅	士口氵小丿
𬇭	氵小丿下
𠿿	口羊手戈
𠹚	口口貝
𢀫	一巛工亻工一几
𢀫	一巛工亻丿士几
𬛲	丿廾至
𪓪	黽口王
𪓪	黽口亻土
𪭸	扌口冫十
𫆸	䏑八酉寸
𫉩	艹口烏
𩘪	風穴人口
𪉥	卜圍乂𠂉母
𡔃	土廿口夫隹
𡔃	土艹口夫隹
𠬒	土厶骨
𥴗	竹糸亠厶儿
𤎎	火广木木
𤎎	火广十儿十儿
𫴳	彐寸王廾
𦁂	糸亻半
𠿴	口石日一寸
𥋵	目立日欠
𢰥	扌艹厶口
﨡	虫生
𤖸	爿丶王
𪺤	爿口力刂
𲎚	王廾士口䒑十又
𨮍	金亠圍口禾
𪁵	尸㇕口鳥
𬊊	火王廾
𰇼	口厶大彡
𣆏	日不一
𪁶	之寸鳥
𩠘	八頁夕卜
𢗠	心七刀
𨯘	金亻亼口口人人
𥻡	米尸目
𥋶	目亠圍口禾
𣛭	木耂阝
𬕻	竹耳田心
橷	木白北儿
𬡋	衤匚巾
𡚦	女丶
𩻕	魚酉冖儿
袩	衤卜口
𥌎	目雨而
𫅡	羊彐丨羊䒑口
𦋦	四十乚屮凵
𤆻	火七刀
𣖙	木羊大
𫃸	糸扌爪女
噋	口亠口子攵
𣾶	氵阝八豕
𫄂	糸竹彐キ
㧍	扌方
𬗂	米耳耳耳
𢫑	扌夕卜
𣼽	氵丶艮月
𬈰	氵亠厶川止
𢴇	扌土半丸
𫬢	口口犬咼
𪁄	鳥士口
𦹸	艹日十田
𢶐	扌虎一口䒑
刧	土厶刀
𣌔	日宀夂口頁
𥡘	禾廿丿用
𩰈	長彡食土土土兀
𬦗	走巳耒
𪒗	四土火氵冖儿木
𪒗	四土火氵冖八木
𪒗	田土火氵冖儿木
𪒗	田土火氵冖八木
悑	心甫
𠻀	口行走
𪅩	厶厶厶人彡鳥
𪮈	扌亻一口乂
𣹗	氵王人彡
𦪼	舟禾尤匕日
𪟓	刀子日匕匕
𢲫	扌馬
𡈺	圍口貝亼冊
𬠨	虫彐キ皿
𦡞	月木木示
𥻹	米艹人木
𫆭	䏑之米
𢸾	扌臼冂一口廾
𫋑	虫王刂王
𣻃	氵亻立口
鴺	大弓鳥
㫻	日亼冊
𬅳	八人口欠門心
𪄸	丰貝鳥
𫿰	宀子文
𬙛	四大冫
𪽛	尸艹廾田
𬂥	木口匕
𠿵	口豸艮
𫸬	冖九弓丨
𱲢	米凵八夂舟皿
𤊭	火广示
𢮫	扌女又弓
𫄆	糸石亠人人十
𬹀	鹿艹亡川
𬚞	丁口耳阝
𩺩	魚四土厶
𣡚	田木木口𠂊貝
𣡚	田木木口刀貝
𣇊	日不口
𦄂	糸廿儿冖巾
𨐿	辛斤斤貝
𤀕	氵宀甘八土
𤒟	火禾㇕丿頁
䱒	魚口巴
𫐮	之亼冊
𢫕	扌丶水
𢪗	扌亻卜
虶	虫丁一
𤻫	疒业羊寸
𡭲	小丿屮凵
𤏦	火丰刀糸
𨠴	酉西
𬨵	之斤丿之
𬂨	木寸竹
𥱫	竹大長
𥈶	目十冂半
𠽕	口扌一彐止
𢫘	扌卜尸
𠸚	口艹勹口
𤍅	火一夕刂火
𤂬	氵石石石
𬀭	日卜尸
𫴾	小日匕匕
𦝎	氵土厶䏑
𦹳	艹亼㇕貝
𢱸	扌之艮
𤴭	疒八
埮	土火火
𧛶	衤行土寸
𠺰	口禾𠂉小
𠺰	口禾𠂊小
𠺰	口禾竹八
𡮣	小門十丿
𦪐	舟囟夂心
𦪐	舟囟丿乂心
𨑜	之下
𤾟	白言午
𦕟	耳丶水
䇻	竹尸毛
𬈅	氵土厶中
𠌧	亻亼口手
揾	扌日皿
紷	糸亼卩
紷	糸亼龴
𲎣	土儿夂齒
𲎣	土八夂齒
𬰓	雨宀䏑又示
𠫾	土厶夕夕
𥰇	竹言十
撔	扌日亠口小
𪝕	亻八刀皿
𪝻	亻至刂氵西
𡫶	宀甘八冫王廾
𡮮	小門心
𫰟	女二𠂊冫
𤄲	氵言艹口丰
𤄲	氵言廿口丰
𡒯	土艹冖一豕
𤁩	氵斤斤貝
𡮍	小扌屮凵
𡍟	扌石廾
𦩳	舟耂
𪡉	口口竹
𪡉	口丿口竹
𦑃	一日乂习习
𡭕	一小
𫵋	立日心小
𤠅	犭不皿
𪨆	小丿火田衤
𠓹	人王亼冊
𧞥	衣冂儿口爪女
𧞥	衣冂八口爪女
𫬊	口貝尸㇕口
𠁚	下亼四日
𢮩	扌子瓜
𪄤	大長鳥
𠰚	口𠂉小
𠰚	口𠂊小
𠰚	口竹八
𬆄	一止宀且
𣅶	日亠八
𥱭	竹亻長
𫅹	耒田
𬧻	婁車
𬔫	立木四貝
𬖮	米刂𠂉丶皿
𥊘	目宀大丁口
𪤍	土尸廿衤
𤺭	疒竹彐キ
𩄓	雨廿乚木
𫔷	門一廾巳心
𡅢	口衤木木示
𧠅	西行𠂉日夂口巴
𬦡	足竹
𡅐	艹亼卩羊䒑口
𡅐	艹亼龴羊䒑口
𠳝	口不口
囒	口艹門木四
囒	口艹門木日
𠺹	口艹大弓
𫥜	冫亼卩亠人人十
𫥜	冫亼龴亠人人十
𠸄	口艹冂大
𤏨	火禾乂𠂇巾
𪔚	士口䒑十又冂一口
㺔	犭爲
㙁	土𠂉母
𢹥	扌厂日月犬土
𠇍	人心
𥇁	目亻丶王
𣌂	日豕耂
𩽗	魚王予丿冂儿口
𩽗	魚王予丿冂八口
𬋼	八乂羊丶水
𪦓	女目巳七
𬬃	金白巾竹
𡃾	口木业半大
𢟞	心冫木日
𨳱	午門
𡡧	女矢口日
𤗲	爿厶厶厶人彡
𡄪	口口虫隹
𪷶	氵爪幺大亼卩
𪷶	氵爪幺大亼龴
𥢳	禾氵耂
𢠦	心廿口夫
𢠦	心艹口夫
𩳳	鬼木人人
𫜹	彐
𢶽	扌阝爪臼
㕪	口冖儿
𨇘	龍足
𡃘	口言火火
䔲	艹癶一口䒑
柪	木幺力
𨀾	足氵女
𱒚	口一口乂
𬉊	氵耳口王
𬉊	氵耳口亻土
𣛠	木四貝
𨭺	金木木示
𪚤	龍亡月王
𪚤	龍亡月亻土
𠑉	亻八人口之艮
𤘂	爿艹四冖夕
𣎏	圍十口𠂇月
蒣	艹行亼木
攊	扌厂禾禾止
𱮆	犭衤刀
𣐲	木口凵
𢲲	扌丶艮阝
𡥵	子日匕匕
𫄕	糸田止匕糸
𤗹	爿釆田
𣼰	氵王廾心
𤥭	王車
𣉐	日之木丶
𣉐	日之十儿丶
抸	扌丿之
𫻂	女又心艮
𠶜	口牛巾刂
𫺼	心爪丨臼
𫕖	阝丁口口亼㇕
𪤻	夕夕皮
𧖐	虫臣𠂉丶四見
𧖐	虫臣𠂉一四見
䈵	竹八厶习习
吘	口午
𨡧	酉爿犬
𠊡	亻羊儿
𠵋	口白工
𤿱	口力刂皮
𤀒	氵亼月刂心
𤀒	氵亼月巛心
𨆥	扌口貝足
𦓊	耂匕亼四日
鈙	金卜又
𧋾	虫口巴
𫤓	亻匕頁之艮
𡅷	口言羊手戈
𥸁	竹廿口夫隹
𥸁	竹艹口夫隹
𥇸	目丘山
𩠴	八頁亼四日
𫔮	門月
𦀹	糸木寸
𪿁	立申手目
𥺾	米止月
𢢉	氵艹𠂇口心
𤟛	犭召儿丶
𩄑	雨十冂半
𡆙	口言召匕匕召儿丶
𢭜	扌士冖几
𦟶	月米卜口
㰁	木石石石
𡀰	口亻山隹
𪁳	口口鳥
𪁳	口丿口鳥
𠰺	口亻弋
𩩬	士冖一几骨
𥟹	禾几一口乂
㳌	氵甲
鱙	魚土土土兀
𢷯	扌匚口口口大
𢘮	心立
𡶀	山冂人
𡵉	山兀
㧼	扌丰衤
㜥	女四貝
𢯔	扌舌刂
𪣾	土厶月匕匕
𫃰	糸厶大三
𤅧	氵丰日虫虫
𤆸	火心
𣈙	日亻一夕刂
𧓆	虫亻一日厶寸
𫩍	厂又雨田
𫩍	𠂆又雨田
𤺴	疒土半卩又
𢯤	扌日匕卩
𢡿	心門木
𢟎	心行走
𥚅	示糸耳
𬩐	之龴用屮凵
𥻸	米四木一
𥒮	石尸毛
𤗤	爿工貝
櫗	木艹四戈人
𪞸	亠乂凵午
𡻗	山十目廾
𡻗	山匕目廾
𡻓	山亻立口
𡚃	金丿屮大
𡚃	金一屮大
𢯜	扌糸卜
𤂱	氵禾丿刀人水
𫼩	扌䒑巾
𠳗	口士冖几
𢴜	扌白⺍儿
𡓄	土艹之夂丰
𪦟	女子方人冫
挅	扌㇕丿木
𠶊	口土皮
𪭃	心雨丿田皿
𠒷	牛儿亻言
𣜰	木广禾禾彐
䁘	目爪午凵
䁘	目䏑午凵
𪨚	尸䒑廾丶王
𣈖	目丰キ
𣅘	日一丂
𢳳	扌山亼冊
𫸉	广予之土羊
𡅨	口竹𠂊厂八言
𫯐	夕夕木一
𤐡	火土鬼
嵿	山丁頁
𥗳	石宀夂口頁
𥮉	竹甫
𫮂	土广由
螉	虫八厶习习
𩊾	革龴用
𬩕	之咼午
𱣜	木扌厂卩
𦚗	月匚巾
𪹜	火广車
𪭥	扌𠂇工
𢫝	扌夂冫
𪵦	立日气
𩚵	食甘
𥞖	禾用
𦪵	舟竹甘廾
𤳧	口口田艹廾
𤳧	口丿口田艹廾
𨃐	足艹厶口
𩤕	馬丰衤
𫃀	米宀女
𫃩	糸女彐丨
𤒴	火氵日幺幺火
𢏿	弓宀夕卩
釖	金刀
鐄	金廿由八
𬁀	氏日小丿
𥬧	竹人上
𧦔	几言十
𢷮	扌业羊寸
𢲨	扌氵𠂉母
𦟂	月之米
𢠄	心山宀示
𩺺	魚白匕旡
𣵲	氵亻半
𣖖	木扌土寸
𫯰	夫千日土
𢂰	巾爪尹
𢂰	巾𠂊尹
𪮍	手甘木
𢘭	心用
𡀷	口之𠂆十目
𨀊	足㇕丿子
𥹀	米心
𠷦	口召儿力
𣘌	木示口儿
𢩮	扌弋
𤃠	氵食爪女
𦄃	糸扌斤口
𥂉	丿屮二欠皿
𥂉	丿屮冫欠皿
𥂉	一屮二欠皿
𥂉	一屮冫欠皿
𡄨	口山女木口攵
𪰓	日干八
埁	土山亼㇕
𤳰	尸毛尸丶一由凵
𤳰	尸毛尸丶一田凵
𫀥	亠乂凵冂厶廿日
𢜝	心一中彐
𦞍	言十䏑
𫓆	金十甫寸
𫼴	手口口
𫼴	手口丿口
𫥛	冫口口口木
𬗽	糸田木寸
忊	心丁
𦹶	艹木貝
糆	米頁圍
𬜊	舌貝刂
𢜢	心行皮
𧋃	虫一亻子
𠿲	隹口日一
𠻼	口艹一口䒑
𣓆	木爪工一
𣓆	木爪丿士
𧿆	足巳
𡱩	扌丿七尸丶
𠞛	户习习刂
𦛍	月一冂土
𬳚	八頁扌足
𧽇	申丿走巳
𨐸	辛癶一口䒑
𬦶	足至刂
𫢍	斤人
𩭜	長彡口欠
𬀶	日生刀
𥿁	糸王
挭	扌一日乂
䌌	糸习习白
𡉽	土亠八
𤻏	疒臼工殳
𢺓	扌雨氵爪工一
𢺓	扌雨氵爪丿士
䃹	石門木四
䃹	石門木日
拪	扌西
𡊸	土戈𠂇
𣌛	日一又又又木頁
𫥯	尸丶丶田凵尸毛
𬍍	犭耂十冂半
𫅰	非心习习
𪸁	氵广廿又土皮
𫁔	穴工匚王
𢜜	心虎
淁	氵立女
𩅻	雨氵耂
𣼱	氵亻日冂厶
𫺽	自心亼卩
𲃪	足文寸
𧺂	耂見土火
𩅘	雨之木口
𢩧	扌乙
𢭻	扌口欠
𤴪	疒几
𢥖	心齊示
𣇜	日貝
𨰲	金臣𠂉丶四見
𨰲	金臣𠂉一四見
𥢉	士冖禾木冂
𡀠	口亻廿丿用
𠼼	口艹爪子
𠐬	亻禾㇕丿頁
𣘈	𠂉木亼冊
𨷯	門臼一乚丨廾キ
𠛌	冖儿刂
嚛	口白幺幺木
𬛘	月八酉寸
𬛒	月氵耂
𥉲	目尸廿衤
𬷊	鳥瓜
𩠔	八頁毛
𡫨	宀弋八山見
𢪮	扌木
𪜾	亻且力
𠼴	口匕頁
𬞚	艹石亠人人十
𬧇	足氵爪女
𡒮	申日一勿土
𨦁	金亻士
𢵉	扌貝丿之
𢚹	心日丂一
𬆅	小冂口一止
𨁬	足亻申
𠔮	禾禾彐凡
𣎷	木乙
𢒎	冖一兀彡
𬙖	四下
𨕭	上之車
𧎝	虫丰一大
𧿐	足千
𤮒	瓦尸婁
𠝕	刀日匕匕
𧿫	足冫十
𠷥	口亠口冖丁
𬺗	立申下
𤇮	火丿之
𠾔	口禾八口儿
𣘁	木丁口丁口
𡃋	亼冊口貝
𫊔	艹耂一夕刂火
𡮓	千北小丿
𥶯	鬼竹由
𬂇	月王刂王
㧵	扌不口
𢪱	扌勿
𢖕	行幺夂婁
𪩬	巴竹
𩚧	食戈
𠅎	亡手丶
𦨑	舟十丿
𪽸	疒走戈乚
𦚔	月召
𥗎	石禾尤匕日
𨅾	足木木木
幍	巾爪臼
𢢲	心艹廿乚木
𤢫	犭一白大十艹
㘃	口艹𠂇口心
𪹰	火文隹
𣞃	口木匚口口口
𥶂	竹甘廾夕夕
𨄟	土隹足
𩷶	魚艹亡
𩳴	鬼土土卜
𪸯	火爪女
𪡭	口酉巳
㳹	氵木王
匬	匚亼月刂
匬	匚亼月巛
𪬲	八刀心心艮
𠜏	口巾刂
𢶶	扌立日心
𧁴	艹亼口口人人刂
𥊗	目氵火火
𢶻	扌艹風
𣠘	木竹白⺍十
𪸟	火夕卜
𬛎	䏑冖隹
𢭫	扌阝一兀
𪬫	立日心竹
𫢵	亻氏一下
𫢵	亻氏丶下
𨘗	之业羊寸
𦵙	艹氵女口
𪷄	氵月八口儿
𠽇	口氵白工
𣄇	方亼冊
𠽛	口阝亼㇕二厶
𨠉	酉心
厔	厂至
𩆡	雨之爪午凵
𩆡	雨之䏑午凵
𪂱	鳥卜日十
𦟍	月艹亠凵人
𦜀	月口犬
𢹨	扌糸厶厶厶人彡
𣲍	氵兀
𪉾	卜圍乂𠂉母攵
𤼓	疒艹臣𠂉丶皿
𤼓	疒艹臣𠂉一皿
𪰃	方𠂉甘廾半
𥧪	王廾穴工
𪾋	刂又皿
𬆃	一止氵一巾
𪽖	刀二阝田
𩮔	長彡冖車
𫡭	土田土乙
𢴞	手四亻
𨖼	之丿四亻
𩙻	乙冫丿刂乙冫非心
𥑶	石耒
𨮈	金立日欠
𠴑	口艹女
𣑴	木氵工
𫜵	爪
頺	禾㇕丿頁
𢰽	扌𠂊彐心
𩅀	雨土半丸
𦚖	月丿之
𪯛	方攵丰糸
𪁴	鳥八人口
𣼯	氵土立口
睈	目口王
睈	目口亻土
𥃚	立日舟殳皿
𢚶	心爪女
𣠰	木竹門日
𨃏	足亻彐冖又
𫃉	西米丿屮
𫃉	西米一屮
𤺯	疒門心
𫮹	土艹一火日小
𬎸	臼儿生
䘜	衤巾
𤽸	白爿士
𫤠	牛儿日匕匕
𧦖	言丿屮
𡱶	尸口口
𡱶	尸口丿口
𣗱	禾刂木下
𣟂	木宀艹見丶
𦠯	月門木
𠸥	口言十
𣎞	巴月土儿夂
𣎞	巴月土八夂
𠽀	口亻日冂厶
𠳨	口𠂉母
𤑉	火臼一乚丨廾
𪔡	貝士口䒑十又
𫥣	禾禾彐丿几
阦	阝火
𣭃	圍人毛
𥱬	竹言巳
𬍄	犭广木木
𬍄	犭广十儿十儿
𥿂	糸心
𩹹	魚隹又
𫐽	之米小丿
𫗁	几二之艮
𡂅	口山囟儿夂
𡂅	口山囟八夂
鴂	㇕大鳥
𢉽	广木十口
𩕳	宀心皿丁頁
𨤵	田土氵火火
𫇶	艹一冂土
𧒅	虫貝丿之
𠼷	厶口十戈口
𢝜	心亠口冖丁
𪱡	月人示
𬜜	舟禾丿刀人水
𢸢	扌竹彑豕
𠤩	四厶月匕匕匕
𩻻	魚一火日小
𠁑	廿儿冖巾下
撁	扌亠幺冖牛
𦕳	耳耂匕
熣	火山隹
𪣱	土立竹
𥺺	米山立
䨔	雨小兀
𫡌	中中半卩
䳧	鳥亻コ矢
𬳕	八頁竹
䁛	目鬼
𣗓	二木耂
𫋩	虫見廿口北火
𫺴	亡心口月
刦	土厶刂
伵	亻四
𥿀	糸日
䓊	艹二乂口
䓊	艹工㇕口
𡏟	土爪午凵
𡏟	土䏑午凵
𨇉	足山一火日小
𬇅	毛匚口口口
𠸼	口之一力十
𤈤	火勹乂凵
𪵤	气丁口
𠻷	口王見
𥌦	目夫夫車
𫃔	米卜口半卩
𧍊	虫厂土土
𬒼	示乚夕夕
𨹬	阝口口
𨹬	阝口丿口
𣖝	木艹亻士
𫱏	亡女艹廾
𨀑	夕卜足
𠦩	十木攵
𢲮	扌耳止
𪮦	扌行日一寸
𢤢	心土儿土丸火
𢤢	心土八土丸火
𡀇	口艹千日土
𨁝	足十冖子
𡾫	山禾㇕丿頁
𦟻	月匚艹𠂇口
𪇌	鳥曲辰
𪟦	田力隹
笣	竹勹巳
𪸔	火止
𣵮	氵丰阝
㕸	口立
𢯮	扌田月
𦨜	舟戈
𧎛	虫穴犬
𣎊	月尸目
𦢳	户月爲
猚	犭隹
𦓅	耂匕艹人木
𬈋	氵刂又皿
𨱪	長冊丶丶
𨔊	之亠人人十
𫡔	竹下乚
𪱮	亡月王工貝
𪱮	亡月亻土工貝
𦂾	糸之手丶
𢷂	扌卜夕又米
𫆿	田月之米
𫌄	衤厶大三
𢯠	扌氵皮
𧘸	衤丿屮
𧘸	衤一屮
𤾰	白匕矢龴足
𣦰	厂禾禾止一口乂
𬩍	之夕夕米
𦼛	艹走人彡
𥉸	目臣又土
𪿄	目竹立申
𤶺	疒口欠
𫑺	酉丿㠯一巾
𬲄	几二穴人口
𥬉	竹勹厶
𧢑	見門日
𩟂	食之咼
𤒠	火耂見
𪹷	火日甘衤
䠏	足癶一大
𨃋	足䒑巾
𨴦	又丰門
𤟂	犭亠厶月
檒	木木風
𨅰	足木了口又一
𨅰	足木丂口又一
𠻉	口之舌
𤔷	㇕丿又皿爪尹
𤔷	㇕丿又皿𠂊尹
𮬩	心鳥
𪾭	目木木
𪬪	竹亼月刂心
𪬪	竹亼月巛心
𠳑	口扌匕卩
𫱩	女又广廿又
𫶾	巾人
𥙪	示乚半
𫾝	广木木手且八
𫾝	广十儿十儿手且八
𫘃	禾日立日欠
𩵿	魚卜㇕
𠁙	不言𠂉匕
𧔚	虫穴身弓
柆	木立
𩕆	立日十頁
𤸨	疒儿⺍小
𫑽	酉足木口
吔	口也
𨯛	金艹阝亼㇕二厶
𦭦	艹丶王
鈢	金木
𧐻	虫土隹
𬱍	川頁方人冫
𦍛	羊丶水乚
𦇮	糸金千日土
𢇢	广山
𠺱	口工凡心
𠺲	口扌辰
𠴤	口土心
𨌀	車耳
𩅹	雨氵尸目
𫪸	二乂口四
𫪸	工㇕口四
𠈋	亻戈𠂇
𤓢	火日衣口口甘
𡂲	口一大上亻一夕刂
𥉫	目立申
𡃓	口扌釆田
𫈨	艹田亻八
𬢀	斤欠見
𡃊	口禾尤匕日
𫧣	十冂半竹
𫇰	艹丨日
𥸒	竹日衣口口甘
篘	竹勹屮勹屮
澾	氵之土羊
㯿	木巛圍乂巛
𤮠	瓦艹冖一豕
𥉩	立申目
𡆗	口之四糸隹
𨇑	足四厶月匕匕
𫈜	艹氵由
𣼮	氵日一止匕
𫤏	亻匕頁之匕卩
𥯒	竹十戈口
𪠺	口扌丸
𠼵	口亻亠口冖丁
膁	月禾禾彐
𠴠	口亼冂人
𫊿	虫八厶廾
𬛩	臣卜十冂半
𪅨	禾夕夕鳥
𨨤	金心土厶
𩈘	一木頁圍
㗙	口勹屮勹屮
鵉	大八鳥
𥳅	竹之言
𪺘	爪尹卜貝
𪺘	𠂊尹卜貝
𪽏	田亼卩
𪽏	田亼龴
𤭵	瓦立日
𪬏	心禾日
𫁧	立行土寸
𫫺	口耳由丂
𬷎	𠂆一口鳥
𣱭	气亠圍口禾
𪡿	口月一巛工
𥸷	米欠
𢷁	扌月十冂半
𦅰	糸西日十
𫐹	之尸目
𥅿	目扌丸
𫒬	金亻夕夕
𦪨	舟足一口乂
𫷞	𠂉㐄非心
𨦀	金口凵
𠶤	口小冂口
𤬈	亻コ矢瓜
𤮗	瓦足夂口
𠸒	口亻口木
𥧩	穴糸冂人
𤯱	大丁口生
𥻠	米目小丿
𡮋	小木攵
啺	口日一勿
𪾦	目卜尸
𨫅	金亻亼冊
𢱒	扌羊大
𦅱	糸虫𠂉木
𣦛	亻小冂口一止
𦊚	四木一
秥	禾卜口
𣈘	日广卜口
𥜀	尸毛示且
𪨐	尸丶冫大丶
㵣	氵日勹亡欠
𦤰	自犬亼㇕貝
𤡌	犭門一力
𠻊	口广廿巾
𡌢	土亼㇕口
𨀤	足耒
𡭺	小丿而
𤞖	犭耒
𨗊	之耂阝
𦗝	耳車斤
𣐆	木七刀
𫫀	口亠八丁口
𬛕	木人人户月
𪟅	冫㇕大刂
𠴎	口氵丿大
𠯋	口八丂
𫲤	召子
嚂	口臣𠂉丶皿
嚂	口臣𠂉一皿
𦝅	月人刀心
矑	目虎田皿
𦡬	月人亠乂凵冂厶
𪁆	鳥𠂆一口
𢶹	扌日立日
𪸽	火亻至
𫻔	心貝戈戈
𡮄	小宀夕卩
焩	火月月
﨏	土八人口
𠓇	小兀丶艮月
𪆣	日亠口小鳥
𬩥	之豕木人人
𩺯	方𠂉矢魚
橬	木旡旡日
𢂜	尹𠂇巾
𣳢	氵夕卜
𪬡	心刂又貝
𥊣	小冂口十目
𡺥	山日冂厶
𦟪	月之車
𢭾	扌艹凡
𢳆	扌士方攵
𢳆	扌土方攵
𢳆	扌丰力攵
𣙙	木木口攵
𥒦	石土也
啌	口穴工
稴	禾禾禾彐
𫣂	亻㇕丿又皿
㖺	口丰日
𦛼	月斤廾
𦟏	月广車
𤮞	山鬼瓦
𡄬	亼口二厶鬼
𡄁	口广亠圍口禾
㖹	口八刀皿
𤞦	犭𠂉母
𠸘	口亻八人口
泑	氵幺力
𡥚	子丁口
𨧆	金不口
𥭶	竹艹亡
𣆯	日行
𥸠	竹骨曲一口䒑
𤺲	疒小冂口攵
𨀽	足口巾
𤻼	疒魚日
刟	召刂
𱏰	小兀雨田
塳	土之夂丰
𢱘	扌立丿彡
𪤿	夕夕土田土
𤶏	疒小兀
𨇵	足土土土兀夕夕
𡆞	口鬥卯亞斤
𤑟	火魚日
𤏧	火竹亼口
𬕹	竹立申下
𦣎	月廿口夫隹
𦣎	月艹口夫隹
𢙔	心示乚
𦮲	艹示乚
𢠧	心囟儿夂
𢠧	心囟八夂
苭	艹幺力
𬑵	半矢一口䒑
𱞋	心卜尸
𨇗	足厂禾禾止
𣰳	毛竹立申
𦟑	月亻大丁口
𫯨	尸毛一大
𪥔	穴工大
𤢗	犭雨田
𠷇	口方𠂉也
𩄲	雨之米
𬖆	竹立申王廾
𢥷	自心匕矢龴足
𨘘	尸毛之木口
𤮾	兀甘
𣙫	木竹立
𨅻	足穴牛口
噒	口米夕㐄
𩖅	婁攵頁
𡅬	口心衣四水
𨡨	酉甘廾
摙	扌之車
𣄒	方人冫一亻土
𬏡	疒戊
𦃐	糸又冫虫
𦃐	糸又丶虫
𬵿	魚艹門木四
𬵿	魚艹門木日
𤚧	口丿七宀牛
𨧰	金千北
𥴘	竹女甘木
𧹿	土火亻旡旡日
𣈜	日日一寸
𠻒	口厂大申
袏	衤𠂇工
𬀛	方齊
𤊧	火十目
𠶥	口穴弓
𩸯	魚又又又又
𣷰	氵山石
鶮	亠口冂口鳥
𪧾	彐寸山隹
㦄	广木木心
㦄	广十儿十儿心
𧃷	艹虎隹一丂
𧃷	艹虎隹丂一
㗴	口門月
𢶸	扌亠圍口禾
吀	口千
嗗	口骨
𡈡	圍糸夂冫
𪃍	日冂厶鳥
𫣚	一口乂木䒑
𬦢	足門
𪤺	夕夕下乚
𣌌	日生彡頁
𥐒	矢一口䒑骨
𧗅	丿皿甘木
𩁦	雨田隹又
𫅚	羊大禾彐
𬠼	一夕刂丿皿
䗊	虫火火
𬪪	酉酉
𥕄	石土田土
𪠱	耳又土厶刀丶
𱥤	毛立申
𧞤	衤艹隹又
𣔩	木口𠂇巾
𫖄	亻尸二コ又頁圍
𬁻	月耒
𣋚	日立日欠
𬉌	氵口十目廾
𬉌	氵口匕目廾
𠉝	亻扌卜㇕
𡿅	山日冂厶頁
𣭛	毛丿之
𢬿	扌戈廾
𫮒	土石皮
𫬱	口之艹日冂厶
𪅤	臣又土鳥
𨖲	丿廾之車
𢊫	广土立口
𠺺	口木土土
𢃉	巾口力刂
𣺼	氵小冖口儿
𪷡	氵虫口勿
𫊐	艹十口土土土兀
𠅐	手丶亡
𥑴	石衣
𨲷	長亠圍口日一
𢹊	扌火立日戈
𣹓	氵艹厶口
鏓	金囟夂心
鏓	金囟丿乂心
𡍞	土一大心
𠦻	半土儿夂
𠦻	半土八夂
𦠴	月王王亼㇕
𫑃	之鹿木
𤿰	王廾皮
𧤹	扌隹𠂊用
𦚐	月宀匕
𧅭	艹日十艹冖一豕
𠝼	甘木刀
𦰣	艹亻氏一
𦰣	艹亻氏丶
𦣗	月食土土土兀
𥢆	禾厶卜貝
𪦆	女石之
𨫵	金圍戈口一
𦡤	月氵隹十
𦟗	月又隹
𠦳	立丿彡千
㖠	口大示
𬖏	米口
𡳛	尸米士口
𧼋	走豸
𢱝	扌艹屮凵
𤝫	犭冂土
躘	足龍
𦠵	月阝八豕
𡄩	口豸艮心
𬴚	亠口冂口宀示
抋	扌心
𥊖	目土隹
𣷳	氵广氏一
𣷳	氵广氏丶
𠿳	口广禾禾彐
㮿	木甲艹二
𢀬	匚コ丶艮月
𢺁	扌西行𠂉日夂
𫾌	土刀手宀弋八
𧂄	艹門𠂊臼
啚	口十圍口
𩯮	長彡氵廿巾人人
𬩇	之力羊大
𥘀	石日宀口口甘衤
𫉸	艹丁口丁口欠
𫗸	八頁廿日
𥺿	米大丁口
䈫	竹糸冂人
棦	木爪尹
棦	木𠂊尹
𫉓	䒑巾木日
𬵎	魚圍巾
𫦬	九且力
𨄵	足心卜日十
𪁇	亠厶儿鳥
𠄼	十冂半二乂
𠄼	十冂半工㇕
𠶆	口之亻十
𬦃	耂乚土火
𬲃	几二丰糸
𫙌	土土卜鬼
𥑲	石日一
𡣨	女艹土厶皿
𨃷	足示口儿
𡝦	女爪子乚
𡯀	午凵木木冖乂凵匕彡小
𦣙	月日宀口口甘衤
𡉏	土巳
𦀑	糸文刂
𱳆	鬼目
𦼨	艹丨日貝
𡮭	巳巳艹廾小
𣋆	日門王
𬋆	火木四竹
𬋆	火木日竹
𡬷	貝刂寸
㩞	扌火火冖木
𬱹	几二北
𫥮	亠乂凵冂一口⺍廾
𢟛	耳心丨弓
勑	木人人力
𠰭	口卯
𬋚	火勹巳釆心
𦡣	月亠圍口禾
悞	心口乚大
𡢼	女艹勹甫
𨀹	足氵工
𬎻	文厂生竹
𢹪	扌米厶厶厶人彡
𪫓	行彐キ竹
𢯧	扌乂乂攵
𥃱	目人
𫏠	足刂𠂉丶見
𩆷	雨人人戈非一
𧋆	虫耒
𪹣	火虎业
𪹣	火虎丘
䁩	目魚
鉷	金艹廾
𡞖	女广氏一
𡞖	女广氏丶
焾	火亼㇕心
𥺆	米口王
𥺆	米口亻土
𦡦	月艹千日土
𨀋	足亻士
𧵑	貝十口
𨣥	酉爪冖心夂
𡓡	土匕禾頁
𠺠	口立申
𣊎	日土半丸
𠱓	口𠂊厂卩
𫆮	月子丿糸
𢚵	心豸
𥭍	竹小大
𫊁	艹氵尸雨
𩮕	長彡亻彐冖又
𣱰	气人人戈非一
𠄀	爪子乚丁一
𨆏	足之八豕
𫼿	手巳攵
𢘝	心𠂉小
𢘝	心𠂊小
𢘝	心竹八
𠮿	口山
𡋦	土一白
𨊋	身四貝
唋	口亼木
䆰	穴匚口口口
𪜢	亠丨日
𡂁	口心千日土力
𢴐	扌禾夕夕
𦁽	糸日王
𫘀	禾日士方攵
𧳘	豸亼㇕口
瀂	氵魚日
𠱌	口弋二
𩹰	魚卜貝
𫑌	之咼水丶
𬈞	氵牛儿心
𢫫	扌彐キ
𦢉	月宀弋八虫
𡅏	口示曲一口䒑
𱶭	禾艹臣𠂉丶皿
𱶭	禾艹臣𠂉一皿
𬜇	舌言
𡓯	土金千日土
𫣣	亻石日一寸
𢲟	扌宀辛
𬟜	一夕刂火艹耂
𥕥	石匚口口口
㖫	口土儿夂
㖫	口土八夂
𬗜	糸千廿
𨒻	之文寸
𬲑	食九日
𦆟	糸艹冖一豕
𠸬	口亻彐冖又
㹟	犭㇕大
𣃤	皮方
𪱟	王刂王月
𦀖	糸土厶力
𣍅	丰衤曲
𦝆	月爿木
𫴿	白勹丶小
𡏽	土习习白
𤷂	疒月巴
𫁰	竹卜
䟘	足亠几
𪱨	月立申
𥴜	竹言召
䐭	月廿儿冖巾
𧋽	虫艹亡
𢄯	巾𠂉母攵
𠀨	下𠂊又
𣞊	𠂉木八酉寸
𧷺	口貝亼冊
𡂉	口扌斤言
𤔛	耳又爪
𦳙	艹至攵
𠰁	口下乚
𪡚	口⺍生
𫡝	㇕丿日一止
𩜫	食木攵
𬓛	示木木示
𥩰	立匚コ
𢆁	巾竹广禾禾彐
𤔻	艹四冖夕爪
𥵿	竹艹冖一豕
𥊞	目圍戈口一
蒥	艹卯田
𢟖	心氵彐冖又
𪷘	氵牛巾刂手
𧏵	虫立申
𢪰	扌一夕
𪤽	土儿夂夕夕
𪤽	土八夂夕夕
𫽺	手日四又
𫽺	手冖二四又
𪴏	木子日四又
𪴏	木子冖二四又
惀	心亼冊
𢠨	心𠂉母攵
琜	王木人人
𬩟	之咼夕卜
𫂗	竹之米
𧸒	矢一口䒑貝
𢫣	扌北
𨃫	亻至刂足
𠓅	小兀艹宀木
𥧎	穴禾日
𨃉	足行土寸
𨰈	金艹勹口攵手
𬟵	虫丿几
𥍛	目山口口厂丁耳攵
𥍛	目山口口厂㇕耳攵
𩸳	魚木攵
𬁄	日十土欠
𢠅	心丰臼
𦝥	月千臼
𩠩	八頁乂乂攵
𬰖	雨臼儿艹四冖夕
𢝙	心不皿
𢵳	扌木木木
𩡋	禾日一大心
𬉣	氵食亼木
𬰘	丰月丘
𤫿	亼木瓜
𩩖	骨王廾
𪅫	土戈口一鳥
𪡥	口氵艹廾
𢟗	心氵日土
𨖨	之禾夕夕
𫛐	圍戈口一鳥
踷	足耂
𥝎	禾乙
𠵘	口門
挄	扌小兀
𩸮	魚丰キ
𢵮	扌予丿冂儿口
𢵮	扌予丿冂八口
𢵻	扌氵耂
𤒚	火氵曲辰
淎	氵丰キ
𬗩	糸石斤
𢠆	心之龴用
𢬧	扌𠂉㐄
𡁎	口臼一乚丨廾
𦞁	月十戈口
𫡂	禾禾彐立立
𥽎	米女禾禾彐
𪿸	石石石竹
梞	木巳心
𣡓	木竹臣𠂉丶皿
𣡓	木竹臣𠂉一皿
𩼨	魚匕矢龴足
𠡎	日一力
㾿	疒丶艮阝
𫽭	手口貝
𢖀	行彐キ中中
𠾣	口木木木
𣛡	木宀日冂厶
𦲾	艹氵土厶
𫯇	士尸之土羊
𡮉	門小
𣭰	厶牛毛
𧖦	𠂉母言糸糸虫
𨃾	禾𠂉小足
𨃾	禾𠂊小足
𨃾	禾竹八足
𩢬	馬卜尸
𫗃	几二亼月刂心
𫗃	几二亼月巛心
𦁣	糸子瓜
𧟝	衤金目目隹又
𨁱	足尸毛
𬵘	魚艹几二
𥋳	目山鬼
𢱐	扌女儿⺍
𣹟	氵工貝
𬝴	艹文隹
𩻟	魚爲
𠤌	勿言耂
炩	火亼卩
炩	火亼龴
𥮈	竹人十艹
𫂋	竹甘木
䋥	糸田土
𠵽	口氵土厶
𢠇	心言午
𩻒	魚竹立
𦤾	至日一
𠍣	亻扌非
𠹱	口氵匚コ木
𤞓	犭牛儿
𡮨	四貝小
𨳒	門小
𫦵	宀丁且力
𥈵	目木四
𥈵	目木日
𠲡	口女子
𢶷	扌𠂊用刀牛
𤀚	氵艹門乂木
𫑏	刀二阝之豕
𤛇	牛十目廾
𤛇	牛匕目廾
𧎜	虫尸至
𢠪	心四土土
𠶛	口亠口小
橯	木火火冖力
𬗆	糸子乚
𤐜	火山鬼
𬡹	西亻白
𫸈	广之米夕㐄
𢵩	手阝八豕
𠏳	千日土亻厶人
𢬨	扌氵女
𬝮	艹米冫十
𤶜	疒爿士
𢯢	扌户斤
𨅀	足米立
𥯌	竹矢口
𫐿	之木口毛
𤝞	犭木丶
𤝞	犭十儿丶
𫆧	月行彐キ
𬈢	氵立卯
𦷨	艹人木十又
𫉮	艹立日欠
𣠕	二木豕耂
𡮷	小臣又貝
𦒮	龍习习
𠽔	口足木口
𪸧	火口巾
𪾁	白氵土厶
𧍝	虫亠八冖巾
𨁧	足山冂人
㕭	口丿大
𢀧	匚コ亼冊
𥐋	矢一口䒑艹乂
𫔤	門文キ
褠	衤甘冂土
𡪇	宀丁亻丨夂彡
𡪇	宀丁亻丨攵彡
𣱆	户氏
𧥇	𠂊用山鬼
𢚽	心氵丁乚㇕
䀩	目夂口
𥩍	穴牙魚日
𣾺	氵門一廾
𨅼	足艹木人人
𪮔	扌氵夂口
𫘶	丘亠口冂口
𫤑	亻户冊隹又
𢵼	扌走戈乚
𢣀	心石日一寸
𢲤	手亠口冂口
𥖩	石亼四日
𨃹	足氵丶艮
韈	革艹四戈人
𬔈	穴由
𫓒	金曲辰
𨮌	金予頁
𨓑	上之匕卩
𫄓	糸四土火犬
𫄓	糸田土火犬
𫐂	宀婁車
𪩨	𠂊四冖夕匚コ
𢪷	扌目
𦀎	糸一夕刂
𤉕	由𠂇火
𧍍	虫木人人
𠍦	亻刂又貝
𨁎	足口王
𨁎	足口亻土
㭳	木耂子
㺗	犭口口甲一
𦄻	糸母貝
𡤔	四貝女厶口
𩙍	風亼月刂心
𩙍	風亼月巛心
𫐝	辛言亠凵人
𧍈	虫广卜口
𡳒	尸毛一由凵
𡳒	尸毛一田凵
𩂶	雨一夕刂
𦾢	艹木甘匚儿
𦾢	艹木甘匚八
𩛜	食文寸
𥐈	矢婁攵
𤠋	犭婁
哰	口宀牛
𡂳	口石石石
𤌅	火阝夂㐄
𡓮	山鬼人人土
𫻜	勿心䏑犬火
𧤁	𠂊用土儿夂
𧤁	𠂊用土八夂
𬂑	𠂇月文厂生
𤊰	火大八又
𤊪	火刂キ廾
𫷚	干八月月
𫴷	彐寸石石石
𧹰	土火禾日
悜	心口王
悜	心口亻土
𢣆	心山亠口冂口
㧯	扌耂匕
𣟪	木耒辰寸
𬍌	犭勹口口口犬
𡣄	女氵弓冫弓冫
𢱓	扌氵牛儿
𩩫	骨日日
𬚺	䏑二欠
𬚺	䏑冫欠
𪬭	心㇕大爪尹
𦀊	糸大弓
𡳢	尸丶耂阝
𢳠	扌艹犬廾
𧋘	虫弋弓
𨃵	足月䒑大
𡅍	口糸土土土兀
𡦶	子瓜鬼冫十
𧑐	虫予丿冂儿口
𧑐	虫予丿冂八口
𨷈	門艹日冂厶
𠶔	口心又土
椲	木㐄口㐄
𥇷	目山石
𫠢	上丁
𪿍	矢口口力刂
𬋳	爪土半卩又
𰇮	𠂊又亼口
𣺺	氵行走
𪝈	亻爪冖又
𢠈	心八刀貝
𤂨	氵木艹日大
𨨫	金爪木
𠙣	几四土厶
𥋸	目雨田
𣜻	木䒑辰寸
𣌋	日亼口口人人欠
𬉎	氵月千日土
𩂑	雨几二
𫣙	木䒑一口乂
𡮗	之小丿不
𥁷	氵丿之皿
䓔	艹耂子
𬙿	羊䒑口口月
𨳦	門又又
𣜱	𠂉木山亼冊
𠵨	口日一寸
𧐿	虫山宀示
𢚁	心巳心
𢱞	手艹屮凵
𠼯	口言午
𫜗	广木木亻一夕刂
𫜗	广十儿十儿亻一夕刂
𧀟	艹厶口㇕丿又皿
𪪩	王廾广廿火
𦄾	糸业半大
𣈰	日䒑巾
㹭	犭申丿
𠴫	口上小又
𫇖	舌文口
𥌈	目臣𠂉丶皿
𥌈	目臣𠂉一皿
𤮟	瓦土鬼
𥵖	竹月田心
𬯩	阝丁口木口𠂊貝
𬯩	阝丁口木口刀貝
𣙦	木疒土寸
𪷃	氵刂又見
𪦲	女厶口四貝
𨂙	足亠口小
𪯼	方齊
𡋂	土𠂉㐄
𥯍	竹木攵
𠲥	口示乚
𦛊	月一亻子
𢶾	扌矢隹
𠸜	牛儿夕口
𥚤	示乚亼木
𫈃	艹犭王
𬨖	辛乙
𡳜	尸毛禾子
𩹭	魚扌土寸
𨄙	足鳥
𩛃	食瓜
𬆒	一夕刂竹
𡣻	女之艹車
𠲢	口口巾
𫢼	厶口亻弋
蜅	虫甫
𠽘	口二木宀口
𠿯	口山鬼
𠲺	口山𠂊又
㵧	氵艹日勹亡
𠎩	亻非心
𠖯	冫𠂉乙
𡍛	土爪工一
𡍛	土爪丿士
𥻻	米糸冂人
𢣈	心巛囟攵
𦃀	糸行土寸
𫌠	亻木一見
𲃟	足人二厶
𢮬	扌屮凵小
𥠭	千日土禾
𬉝	氵爪幺大夕卜
𤽗	白卜丂
𠄶	亻工一二乂
𠄶	亻丿士二乂
𠄶	亻工一工㇕
𠄶	亻丿士工㇕
𫺲	月夕夕心
𠢟	且力扌丸
𪭳	手艮
𪡦	口疒卜了
𦹱	艹貝斤
𤈡	火山兀
𪹾	火宀䏑又示
𣖘	木糸工
𫵊	小丿糸士口
𭆺	口干
𫴲	彐寸刀二阝
𬠳	虫艹四冖夕
𥚯	示乚日勿
𧐽	虫氵火火
䊷	糸十丿
𠵐	口心土厶
𣰵	毛龍
𨕀	之气矢
𡐯	土厂頁夂
𪵚	毛亠幺
𦬻	艹女又
𠲟	口亻牛
𣮮	尸目毛
𤻔	疒艹耂
𪽞	立申田
𫸱	弓示乚
𦎛	羊女㇕一口
𪱕	日耳又竹
𪱕	冖二耳又竹
𡮠	𠂉小尸目
𡮠	𠂊小尸目
𡮠	竹八尸目
𣙮	木齊示
𠎴	亻尸毛𠂇巾
𨮋	金亼月刂心
𨮋	金亼月巛心
𬏘	田艹廾艹四十乚
𤄰	氵立丿彡頁
𪟳	午竹
𤻎	疒木木示
𩂄	雨丿屮
𩂄	雨一屮
𬮎	羊大門
𫑋	之木口厶牛
鐷	金艹廿乚木
𤑮	火艹日大手
𡇻	圍亠人人十
栍	木生
𫫑	口力亠人人十
𢙲	心口口
𢙲	心口丿口
㮩	木自心
𧛊	衤廿日
𪰤	日氵女
𫅴	耂匕女又
𪥞	羊皿大
槣	木宀大丁口
𠴞	口亻半
𢆧	土半木攵
𥻽	米犬士口
𢦄	心隹言隹
𣱬	乂𠂇巾气米
𫶱	工丂艹日十
𫯿	夫門一廾
𢤝	心竹戊一口
𣆱	日一亻子
𫠸	上氵小月
𪠉	厂止竹
𫏙	足扌爪女
𪨄	小丿八刀貝
𨖅	之丶艮阝
𢮀	扌衤刀
𱪤	火兀
𫧪	丿廾曲辰
𦓡	广木木而
𦓡	广十儿十儿而
𣋑	日艹廿乚木
𠹌	口厶月匕匕
𡮸	巳巳艹廾小大
𨧝	金亻日一
𡗐	艹四冖夕匚コ
𤯶	刂キ廾キ生
𫄈	糸艹氵夂口
𣋃	日人户口刂
𬌓	爿心
啂	口爪子乚
𨩠	金小丿目
𢩿	扌士
𪺖	爪宀㇕皿丨
𦡡	月石日一寸
𧰜	虎一口䒑千日土
𫯩	大十艹一大
𠎨	亻糸亼口
𠶀	口冖儿木
𠶀	口冖八木
𪾝	舟皿米凵八夂
𡐚	土魚
𦓉	耂匕足夂口
𣙩	木山宀示
𪽅	广氏一生
𪽅	广氏丶生
𥈰	目氵艹廾
𠶑	口米凵
𥌫	目竹彑豕
𬳘	八頁小月
𡄎	口金白巾
𤝋	犭文
𫤩	冂人彐夕
𫃶	糸氵夂口
𪶩	氵厶口心
𤌣	火西木
𪱘	曲月西女
𣉍	日田衤
𣰴	竹立申毛
𠺼	口米欠
𫪹	王廾十口
𨄴	足土半丸
𥱮	竹扌爪女
𥋺	目宀爪臼
𠠊	冂䒑山刂二日
𦝍	爿木䏑
𡮵	小冂口千日土
𧊕	虫戈𠂇
𩿨	丘鳥
𪿱	石舟皿
挒	扌一夕刂
𨉠	身扌半
𢅬	白巾十目廾
𢅬	白巾匕目廾
𢥪	心廿口夫隹
𢥪	心艹口夫隹
𠌦	亻糸冂人
囕	口臣𠂉丶四見
囕	口臣𠂉一四見
𦋕	冂乂乂行皮
𡆌	口馬丿大口冂口
𫾆	扌宀日冂厶
𠊝	亻弋厶口
𥶄	竹女木口攵
𠽑	口一口䒑十又
𩆋	雨扌爪午凵
𩆋	雨扌䏑午凵
𨎠	田夂口車
𬔔	穴工立申
㩃	扌宀甘八冫
𢹆	扌言匕匕白
𥴚	竹自⺍十
𡃛	口言羊又
𥰄	竹艹勹口
𧘪	衤牙
𬥬	八刀貝文隹
𢭑	扌丿七尸丶
𢯗	扌禾子
𪻃	犭行彐キ
㕰	口毛
𤹪	疒匚口口口
𧧯	言小兀
𪖫	自田廾𠂉母
𢆨	木夂土半
𪷔	氵殳亻夕夕
𥗏	石火火冖王丶
𤉇	火口乚大
𦠳	月尸子子子
𦗽	耳疒白勹丶
𣉸	日言巳
𱳍	目足夂口
𤏪	火火火冖力
㛎	女口口
㛎	女口丿口
𣟮	予丿木囟儿夂
𣟮	予丿木囟八夂
𬀦	一乚日
𨆺	足氵西示
𠽦	口氵戊一口
𣒾	木艹凡
𬞷	艹言犭王
𡉦	土午
𱢎	日衤刀
𬰢	宀弋八山頁圍
𠱤	口耒
棿	木臼儿
𫲎	女艹日大心
𬆈	一止亻小冂口
𬛠	亠厶月食爪女
𪨅	小矢隹
𪿙	石𠂇火
𤷮	疒行丶王
𫮷	土田土立口
䐗	月耂
𥚇	示乚舌
㩫	扌斤斤貝
𢲥	扌金十
𦟋	月亻立口
𨠵	酉小兀
𬩁	之十又口力刂
鎫	金宀乂八夂
𫤎	亻匕頁行一止
𫺎	心丰阝
𠅻	亡氵口月
𥾛	糸七刀
𩻹	魚十日十月
𣲠	氵一夕
𦝈	月日厂人
䖴	虫儿⺍
𣜸	木日冖車
𤀓	氵示彑水
𧿳	足弓刂
𫮥	土隹𠂊又
𪱴	木女
𤭚	瓦牛口
𬷞	木木鳥
𤬪	土瓦
𢆫	𠂉㐄止戊一癶
𠾕	口阝八豕
𫅟	羊大宀一兀卜又
𢁑	巴木口𠂊貝
𢁑	巴木口刀貝
𤋻	火氵𠂆亻
𠞢	王刂王刀
𫤍	人王言亼冊
𫮇	土石人人
𢭶	手尸毛
𣘊	木行走
𫆽	亠厶月厶月匕匕
𤁘	氵立申中
𡁞	口亠口冂口卜又
𬖷	米卜口門日
𤖶	爿一冂人
𢯒	扌艹不
𫌖	衤夫夫車
𢵭	扌艹木人人
𤇊	火干八
𫙔	魚卜尸
𢙵	心乂𠂇口
𠬉	土厶爪尹
𠬉	土厶𠂊尹
𦀴	糸艹亡
𤒦	火亼口口人人攵
𫂝	竹𠂊冂人冖夕
𧹟	土火宀匕
𠯅	口弋
𡀡	口氵弓冫弓冫
𥼱	米丿大口冂口
𪿥	石木攵
𣈚	日爿犬
𦵛	艹手屮凵
𡣧	女厂四貝
𪡴	口言巳
𨃊	足卜口火
𦄸	糸言八厶
𫒃	千日土尸匕
𪯵	匚王方
𡳁	尸米大丶
𩿙	鳥戈
𧎴	虫扌斤口
𬧆	足目巳七
荱	艹尸毛
𡹠	山宀且
𡁾	口言八口儿
𪆧	鳥走戈乚
𬑅	目竹
𤶈	疒西
𣻆	氵子丿糸
𣐳	木口乂
𨮵	金艹冖一豕
秲	禾土寸
𦄄	糸尹口阝
𩪞	骨巳巳艹廾
𦝊	月之丿屮
𦝊	月之一屮
𫮋	夕卜人人土
𢃊	𠂇巾㇕一口
𫋨	虫言木四
𫋨	虫言木日
𤆈	火㇕丿
𪜝	予甘廾
𬇁	毛山亼㇕
𤀜	氵目丰月
𡹡	山亠口小
𪠞	夕夕土厶
𦆹	糸业羊寸
褀	衤甘廾
筪	竹匚甲
𧣧	𠂊用大弓
𫸊	广廿一由八亠厶儿
𪥯	竹女又
㕵	口王
𣊘	日魚
𠸓	口扌舌
𣔡	木土皮
𠽃	口土半丸
𤃛	氵西示瓜
𪭮	扌人人人
𥽡	八刀米田艹廾
𪡩	口山厂火
𢚷	心車
𪟐	八刀爪尹
𧹱	土火甘匚儿
𧹱	土火甘匚八
襎	衤釆田
𡀱	口口丂虎
𣒣	木艹亡
𨡉	酉彐冖又
𢁍	巴爲
𠸪	口氵夂口
𣙪	木广木木
𣙪	木广十儿十儿
𢏡	弓牛儿
𬜎	舌貝丿之
𪾺	宀弋八山目
𡳣	耂阝尸丶
𠾾	口氵日业
𫂚	竹木𠂉母
𩼢	尸口辛魚
𬝐	艹卜口火
𨮑	金亻山隹
𪿹	石卜了日冂厶
𥹵	米木口
𠃝	乙小
𡼸	山竹彐キ
𢵲	扌口立丿彡
𫤈	亻八人口之艮
𢃈	巾王廾
𪥷	亻白女
𠻅	口石丿之
𧶮	貝圍十口
䈊	竹土儿夂
䈊	竹土八夂
𩽖	魚竹馬
𥌥	目言田木
𥑥	石生
𥷒	竹厂禾禾止
𠰂	口一兀
𦛜	月亼㇕口
蘝	艹亼口口人人欠
𫒅	千日土耳又又
𨭑	糸亠厶儿金
𡎤	土羊大
𤠹	犭廿儿冖巾
𥇀	目艹亡
㨶	扌鳥
𣑌	木乚召
𥆂	目亻工一
𥆂	目亻丿士
𣼩	氵阝亼㇕二厶
𬲞	食女甘木
𥓸	石衤彡
𤡱	犭中一貝
𤗆	爿𠂉母
𪮭	扌走𠂉小
𪮭	扌走𠂊小
𪮭	扌走竹八
𣎃	月小冂口
𩜽	食文厂彡
𫏓	足千北
𠠩	田夂口䒑月刂
𥃞	尹一火皿日勹亡
𤄮	氵土土土兀夕夕
𥉬	目一夕刂火
𤀏	氵言弋工
𪮨	扌氵冖儿木
𪮨	扌氵冖八木
𫆡	亠厶月竹
𦠆	月巳巳艹廾
𬙴	羊大丿屮
𬙴	羊大一屮
𧁺	艹糸戊一口
𬊢	火門亠巾
𦪃	舟冖一豕
𠄺	二刂見
𪡑	丁口氵女
𪢣	士口䒑口日月
𡭦	小木一
𤍇	火辰寸
𣒳	工木王
𣘆	木糸冂人
䈹	竹宀亻一白
𩫦	亠口冂口厶厶厶人彡
𨁥	木土足
𫺧	心亼⺍口
𢟚	心亡口月
𫌎	月八口儿衣
𬛟	月土厶卩骨
𤐛	火門亠巾
贑	立日十工貝
𢜫	心小丿目
𢌊	广廿一由八王廾
𦧜	舌一口乂
𦲒	艹厂土土
𨁡	足爪女
𫖧	頁日亠口小
𤥑	王亡女
𠿷	口門亠巾
𨅁	足竹立
𥄫	目𠂊又
𫴼	門十丿小
𦁁	糸心彐丨
𦁸	糸亼口卩
𬁏	文寸日勿
洷	氵至
䉒	竹釆田
㙴	土𠂊厂八言
𤹿	疒魚
𤅶	氵言糸糸攵
𧑆	虫立田土
𧞾	衤四土火犬
𧞾	衤田土火犬
湥	氵穴犬
𨄞	足之木口
𩄶	雨米欠
𠖭	冫了
𡭰	儿⺍小
𠩕	厂米
𣦎	一止小冂口
𪽩	疒亻㇕丿
𣷠	氵日月
𣇟	日宀牛
𪡫	口土口衤
𠶍	口木冖儿
𫩺	口尸丶冫
𥶱	竹白鬼
𧐹	虫禾夕夕
𩠓	八頁𠂉乙
𦟿	月土隹
𫥫	尸至屮凵
𤗖	爿子皿
𩾰	止鳥
𣒠	二木曲
𪳴	木几四土厶
𢽼	巴乂乂攵
𣙨	木竹皮
𬩏	水丶之木口
𡮈	爪子乚小
𦛋	月士口
𨅉	足丶艮月
𪞀	小兀竹
㗩	口习习白
𫊹	虫人二厶
哴	口丶艮
𢥆	心竹立申
涖	氵亻立
𩹤	禾火魚
𬞕	艹門木四
𩂐	雨工一
𩂐	雨丿士
𣁔	文口匚コ
𢞄	心土𠂆一口
𫠷	上亻丰キ
𬛙	月長干八
𢙪	心文寸
𫴚	宀弋八山山亼㇕
𬈓	氵冖儿尸匕
𫇀	月厂禾禾止
𬹹	齒艹巳巳艹廾
𫯊	甘木夂力
𠽊	口𠂉母攵
𫯲	且力大弓
𣞶	木夫夫車
𡤟	女子石石石
𩺋	魚疒卜弓
𧏶	虫阝車
𫾑	扌竹甘廾
𣖢	一木亠人人十
𥍑	目車丿大口冂口
搎	扌子丿糸
𠳹	口广木
𫆉	禾火耳
𩆪	雨艹四戈人
𥺏	米口欠
𠼳	口十口十𠂉乙
𩝺	食扌爪女
𫉼	艹四戈人竹
𡏡	土立申
𠱀	口皮
𡀯	口亻一日厶寸
𱿂	艹日冂厶頁
𢋴	廿儿冖巾广氏一
𢋴	廿儿冖巾广氏丶
抯	扌且
𫬍	口非衣
𤇢	火白
𦙫	月一止
𡗉	土土土兀夕夕
𭢥	扌艹氵夂口
𣛢	木尸毛且
𪮊	扌大八十
𪳫	又又又木由
𢟓	心宀辛
𫵡	尸毛冊
炪	火屮凵
𫢩	尸匕亼㇕
䀧	目艹廾
𫭧	土㇕丿子
𬛛	北月甘廾
掋	扌广氏一
掋	扌广氏丶
𥬩	竹尸匕
䖷	虫乂𠂇巾
𡽫	山女木口攵
𢴙	扌口木人人
𦁾	糸工冂大
𣗑	木阝車
𫙍	鬼子皿
𡉕	土丸
𬖭	米卜口日一
𧷸	貝艹日大
㩜	扌臣𠂉丶皿
㩜	扌臣𠂉一皿
𤻓	甘廾疒一冂人
𢟒	心厶月匕匕
𢝆	心千日土
𤿦	皮夕夕
𬩲	之斤宀䏑又示
㨋	扌耂
𫴞	宀心皿丁亻也
𥨋	穴牙王廾
𥪸	立竹土寸
𣞻	木四厶月匕匕
𡄡	口齊示
𬵤	魚扌立女
𧒍	足夂口虫
𤃜	氵之一火日小
𬇮	氵殳亡
𣽊	氵卜冖一八人口
𠎪	亻尸婁
𢯥	扌艹一兀
𫶵	巴㇕丿
𫽿	扌白⺍十
𱹵	糸門心
𣂋	户冫十牛口
𣍕	曲土土土兀
𫇟	舟非心
𢮭	扌目廾
秷	禾至
訔	山言
𢟏	心一夕刂火
𣔞	木子瓜
𤶐	疒一亻子
𩶪	魚至
𠾦	口非心
𠼺	口心⺍甲一
𠼺	口心八甲一
𬳨	馬彐
𡃚	口广田土八土
𡍙	土艹几二
𩠭	八頁尸至
燶	火曲辰
𪶾	氵阝乚一冂人
𢆥	十冂半𠂉㐄
𪞴	几言十
𠳺	口文口
𢹩	扌雨木目
𫘼	長彡由
𬧮	身糸冂人
𨭡	金氵爪臼
橽	木之土羊
𢢅	心十日十月
𱓄	口艹几二
𫄋	糸言土寸
𠓺	𠂉廿廿火人
𬪮	酉石一廾
𡎦	人人土夕卜
𬠢	虫示且
𠐅	亻耳宀且
𠳘	口亻丨夂
𠳘	口亻丨攵
𧋹	虫一大上
𥃨	目卜
𤸭	疒行走
𣍍	冖召儿丶曲
𥶮	竹木山隹
𩇛	生丰月
𥻺	米爪幺大
𣉶	日耒毛
𡀵	口言大一丂
𡀵	口言大丂一
𦹵	艹日十十口
𤈞	火耒
𫑊	之力口貝
𣼹	氵目艮
𤁕	氵辛木口
𠾷	口土半卩又
𦅭	糸阝八豕
𡉖	土弓
𫬩	亠八冂儿口大十艹
𫬩	亠八冂八口大十艹
𤢤	犭亠圍口禾
𥮋	竹亻木一
𦩛	舟目廾
㘙	口口口厂丁耳攵
㘙	口口口厂㇕耳攵
𬦄	土火耂見
𬳙	八頁广由
擃	扌曲辰
𡓆	竹立人人土
𫽎	扌亻夕夕
𥾃	米言糸糸虫
𱓳	口四一止
𤁛	氵耂㇕丿子
𰔐	手爲
𣕃	木日冂厶
𩷇	魚乂凵儿
𬛦	臣卜立
𦲺	艹亻一口乂
𡂀	口木亠口冂口
𤎜	火丶艮月
𣁲	冫十夂冫
娫	女廴丿止
𤘋	牙手戈
𣫲	母亻丁
𩵽	魚心
𠂎	丿凵
𩴅	鬼丰刀大
𡮪	小甘廾欠
𤃧	氵扌之土半
𧋺	虫士心
𨂕	足木木
𱱽	白丶艮月
𠞡	骨刂
梹	木斤廾
𬙵	羊大一冂人
鮉	魚召
𫯡	大干八
𬊴	火田北
𫗶	八頁爪丁
𪟼	亠人人十巳巳艹廾
𫢫	亻弋廿乚
𣹔	氵之冂口
𨮐	金之𠂆十目
𣈛	日舌刂
𧷹	貝之牛口
𪺇	火亠乂凵冂厶隹
𤘁	爿艹冖一豕
𤀖	氵山鬼
𬜝	𠂊巴厶牛
𬚈	习习宀一由八
𤏤	禾乂𠂇巾火
𧔙	虫日艹廾水
𩯯	長彡召儿召儿
𢲪	扌土田土
𬳛	八頁婁攵
𡭻	小大丿屮
𡭻	小大一屮
銊	金戊一
𣩂	扌斤一夕匕
𣋾	日言田木
𬝗	艹心衣
𦡶	月臣𠂉丶皿
𦡶	月臣𠂉一皿
𠿄	口宀日冂厶
𬗗	糸扌斤
𥗨	石艹日甘衤
䄇	示口王
䄇	示口亻土
𠶕	口氵召
㾾	疒禾禾彐
𡔿	士冖几丰一大
𫻉	刀丶心𠂊貝
𬲁	几二十冂半
𤚇	牛羊又
𨀏	足日一
𤠰	犭甘冂土
𫖂	刀二阝頁圍
𫵍	小止小頁
𪠠	厶矢亠凵人
𫫜	口犭丰月
𦼚	艹木木木
𬲉	乙冫白
拰	扌亻工一
拰	扌亻丿士
𡑝	土米夕㐄
𢌌	王廾广廿由八
𧔿	虫用口隹
𦠘	户月木人人
𦥃	至冊廾
𤬲	瓦冂人
𪭇	心羊言言
𫐪	之力𠂉小
𫐪	之力𠂊小
𫐪	之力竹八
𥆽	目口亼㇕
𪾉	皮耳阝
𥹘	米一冂人
𩈩	頁圍刀二阝
𡫐	宀立丿彐刂八
𦷯	艹土田土
𠒬	小兀戈口一
𢩤	户隹日四又
𢩤	户隹冖二四又
𤲼	田衤申丿
桗	木㇕丿木
𫊮	虫卜尸
𦛾	月心彐丨
𧜺	衤虎彡
𢢽	心豸艮
㮈	木大示
𤊤	火山石
𩘩	風之艮
𦄺	糸丶艮月
𨄃	足之豕
𡮞	宀丰口小丿
𣱼	氵刀
𦨂	甘木𠂉廿廿夕㐄
樍	木丰貝
𬰊	雨之言
𥇂	目口力刂
𡭱	屮凵小丿
掿	扌艹𠂇口
𢯝	扌氵半
𫿹	艹巾斤
𧎸	虫亠口冂口
𥉯	目木土土
𫇁	月千日土土八夕
𦀍	糸厂止
𦂛	糸方𠂉也
𪵲	氵圍凵
𦹺	艹文見
𡝃	女止癶
𫔭	門一廾
𢒞	木四彡
𢒞	木日彡
㓶	丰刀大刂
垉	土勹巳
撘	扌竹亼口
㹥	犭丶王
𧺃	土火耂見
𩗃	風且
𫽂	扌十又八刀
𠍥	亻貝丿之
浗	氵十⺍丶
𫼙	手氏
鑥	金魚日
𢬗	扌耒
𢧚	𠂉㐄戊㇕
𬆗	厶口一夕匕
𤵊	疒丿屮
𤵊	疒一屮
𬩓	厂止之木口
𡮺	臣又貝小
𪢘	口辛木口
𧻭	走申丿
𢳙	扌穴儿⺍
𫵟	尸丶扌丿七
𦁿	糸女十口
𡼈	山土半丸
𢲬	扌一夕𠂉木
𥀳	皮木艹日大
𢲦	扌耳戈
𣟭	木口口馬
鋦	金尸㇕口
𠼦	口日四又
𠼦	口冖二四又
𦑗	户习习㇕大
𨂔	足亠厶月
𥻢	米口自
𩶱	魚宀丿七
懢	心臣𠂉丶皿
懢	心臣𠂉一皿
𢩪	扌了
𫏝	足米且
𥐍	矢一口䒑一口䒑
𨷶	臼一乚丨廾キ門
𱎃	氵㇕丿乙
𣆰	日大弓
𨇓	亻亼口口人人足
𡶨	山厂千
𧋁	虫一冂土
𨢟	酉艹亠凵人
𢴖	扌户攵口
𤀔	氵食欠
㖇	口而
𪃵	鳥木日一
𫦓	方𠂉矢刀
𧖱	丿皿卯
𠓬	文口人
𫅞	丶艮羊䒑口
𪦚	女貝攵
𫃷	糸尸目
𠑈	亻氵臣𠂉丶皿
𠑈	亻氵臣𠂉一皿
𬏴	疒心又土
𨙥	之丰日虫虫
𢀦	匚コ户斤
𥢄	禾囟又儿夂
𥢄	禾囟又八夂
欗	木艹門木四
欗	木艹門木日
𤷱	疒門
𠺧	口亻丨夂木
𠺧	口亻丨攵木
𫶰	羊工十又
𨫊	金西木
𫐚	辛木乙
𨀻	足戈𠂇
𠀪	甘廾丶
𢭷	扌土文
𬴑	王廾骨
𠁝	立立戊一口
𤋵	火行土寸
𡅌	口竹門月
𢭳	扌酉
𫇥	䒑卜
𣼾	氵耳卯
𬓞	亠乂凵冂厶土厶
𨇬	足日一金欠
𩙹	之夂丰乙冫丿刂乙冫
𩄨	雨骨
𩅙	雨厶厶厶人彡
𪻟	王㇕𠂇巾
𠺟	口广車
𥷻	竹雨之米
𪰿	日一止宀子
𠲨	口氵也
㒷	冂人廾
𪽱	疒穴力
𫔯	門冫十
𣜷	木禾火心
𧣳	𠂊用八人口
𬏻	疒𠂊圍八乂乚丿
𡋁	土䒑巾
𬮜	門一大
𥊠	目山宀示
㮲	木勹屮勹屮
𬉆	氵尸婁
𧐖	虫之車
𬋟	火日冖口口甘衤
𡃿	口扌之土羊
𬛉	北月八厶
𠲖	口衣
𪡇	口亻𠂉小
𪡇	口亻𠂊小
𪡇	口亻竹八
𫥊	冫𠂊厂卩
𡥥	子夕夕
𤞧	犭圍木
臁	月广禾禾彐
𥾘	糸土
𢥇	心口口甲一戈
𥻮	米宀辛
𫥘	冫亼卩士口
𫥘	冫亼龴士口
𫹊	手一丰冖一兀彡
諪	言亠口冖丁
𪾆	皮竹
𫶳	工四耂
𬖽	米氵廿巾人人
腀	月亼冊
夦	甘匚儿夕夕
夦	甘匚八夕夕
疪	疒匕匕
𪿘	石厶口
𬁊	日行亼木
𢵯	扌四貝
𠛣	日一刂
𢖖	婁行幺夂
𣵵	氵山𠂊又
㑍	亻耒
𪰂	方弓刂貝
𫬮	二乂口石亠人人十
𫬮	工㇕口石亠人人十
𢬄	扌冫水
𣒴	木禾㇕丿
𡸇	山夂木
𪅧	土隹鳥
𢯟	扌土日一
𬈭	氵千日土力
𫥌	冫王廾
𬪐	䒑八日阝
𫑾	酉亠圍口示
𬧡	身亠八
㐌	𠂉也
𢞅	心西女
𬄅	木氵日工
揂	扌八酉
𪥉	一大巴
𥌀	目宀䏑又示
𪢒	口婁攵
𧑃	虫士方攵
𧑃	虫土方攵
𧑃	虫丰力攵
𦞔	月心小兀
𧋉	虫八人口
𡖵	亠亻夂丶卜口
𢖺	心弋
𬸴	卜圍乂亠圍口禾
𫤡	小兀田糸
龱	圍乂
𠅍	一木亡
𣑁	木亠厶儿
𠼪	口禾夕夕
𫸷	弓丨王廾
𡨹	宀寸宀丁
𠖿	冫用
𢸵	扌尸口辛土
𱟦	之夂丰户方
𣋨	丰日亻彐冖又
𧌀	虫一大口
𪓫	木彡黽
𡑖	土阝八豕
𥌙	尸目广車
𦛻	月木寸
𡍚	土木木
𤐚	火立日欠
𩯂	長彡艮旡
𩩪	日日骨
𬋰	竹毛爪
𢭮	扌巳攵
𣦓	一止卜貝
𪻈	犭弓厶虫
𱘅	土足夂口
𩵾	魚十又
𬷩	隹又鳥
𤮿	甘兀
逎	之酉
𠀿	下口欠
𤃢	氵广亠圍口禾
𡆚	口行目目隹
𬰆	雨氵爪尹
𬰆	雨氵𠂊尹
𧹅	土土土兀八刀貝
㝹	小丿召儿丶
𠴘	口木寸
䱊	魚米
𢷄	扌氵戊一火
𤠷	屮一虫犬
𣉎	日木日一
𣑻	木𠂉㐄
𥶳	竹糸戊一口
𡀦	口氵日皿
𠺦	口亻廿日
𤞒	犭艹廾
𧣲	𠂊用一日乂
𪱂	日犭耂
𬒧	石皮臼工
痶	疒冊廾
㤳	心不口
𬇏	气木
𢴉	扌艹亼木
𣼶	氵門口
𡂷	口宀艹見丶
𫥏	冫木攵
𣗿	木示且
𫹗	行日文
𬘊	糸四厶月匕匕
𬖪	米尸䒑廾
𬊽	彐火士尸
𨦧	金𠂉㐄
𥮊	竹木土
𠱄	口皿
𪣠	土文口
𬘀	糸氵臼工
𨍦	車婁
𫁫	立阝夂㐄
𣍁	尸毛曲
𬞰	艹丨日婁
𦀵	糸中中
𨇹	足亠乚凵隹瓦
𫻈	女又心亼㇕口
𢴌	扌門口
𫡀	立立齊
𥋒	目矢口日
𫏥	足言大一丂
𫏥	足言大丂一
𩛄	食一冂人
𧐼	虫扌卜日十
𢣃	心石亠人人十
𬠓	虫禾子
𤻭	疒言二乂口
𤻭	疒言工㇕口
䟢	足𠂉小
䟢	足𠂊小
䟢	足竹八
𬜌	舌方𠂉也
𪡆	口扌亼㇕
𨃼	足示𠂉匕
𩚩	食十口
𦠶	走召䏑
𱸣	竹女夂田
𥶀	竹糸黽
𤉘	火言
𢴝	手艹阝一兀
𪡾	口竹生
𦺓	艹十日十月
𢩛	户工貝
𫺾	八刀心亼㇕口
烣	火𠂇火
𡀴	口扌烏
𫿨	方攵宀立申
𩽉	魚疒臼丨又
𪡍	文口竹
𫍕	言巳竹甘廾
𧁸	艹彑宀田木
䏧	月夕夕
𣶈	氵冂䒑亡
𦖻	耳田心
𪢏	辰口氵也
𣾵	氵糸𠂊巴
𬐩	不皿㇕一口
𠫅	艹厶口厂日子
𧞋	衤广禾禾彐
𨄁	足耳冖儿
𡃖	口虎田心
𠢞	扌丸且力
𧋻	虫文口
𡥤	子耒
𤒛	火耒辰寸
𬁉	尸匕亼㇕日
𠽖	口之豕
𥻣	米扌土寸
𤂪	氵雨辰
冡	冖一豕
𪠢	土厶广廿由八
𫗾	禾日十目
𫷐	巾艹千日土
𫽑	殳扌日
𠂪	㇕丿亠卜
𪵬	氵丿几
𫱪	女子小冂口
𡑲	土木木示
𩻑	魚米立
𪳞	木耂子攵
𣝅	木匕矢龴足
𥕊	石艹大廾
𫅤	习习亼卩
𫅤	习习亼龴
𢯖	扌心土厶
𪜉	中干八
𫚱	鳥勹厶
𤹗	疒八厶习习
𦑅	一巾人人习习
𫂪	竹丿大雨彐
𤻾	疒弓口口甲一
𩻔	魚之扌斤
𪬶	心糸𠂉母
𥊚	目广木木
𥊚	目广十儿十儿
𠉠	亻豸
𬄞	二木犭耂
𫂨	竹土寸一口田
𣱾	氵了
𡐗	土𠂊用冫十
𦟣	月囟儿夂
𦟣	月囟八夂
𫻽	戊㇕𠂉㐄
𬘂	糸予頁
𢚳	木寸心
𡐘	土氵白工
𪡈	口亻白
㨄	扌用口
𬙺	羊大八厶廾
𢅅	巾厂䒑屮欠
𬚎	糸木四耂匕
𬚎	糸木日耂匕
𬦨	足口卩
䱑	魚扌斤
𢧲	手戈止匕二
㭽	木广氏一
㭽	木广氏丶
樑	木氵刀八木
𱐾	馬勿
𣒱	木口欠
𢹾	扌丿㠯止彐冖巾
𡦧	禾子亠人人十
𥱰	竹行走
𢷳	扌𠂊冂人目夂
𬁚	日生臼人
𱡵	艹几二方
粚	米𠂉也
𦠲	月亞心
䇮	竹亻工一
䇮	竹亻丿士
𬌥	牛婁
𦃿	糸四土厶
𡂇	口口囟儿夂
𡂇	口口囟八夂
𨆶	足艹氵甫
𪖺	白田廾艮旡
𤞔	犭弋工
𭖌	山日一
揁	扌卜貝
𬌕	爿亻木一
㗖	口爪臼
𥗽	石臣𠂉丶四見
𥗽	石臣𠂉一四見
㳻	氵廿日
𢞃	心糸工
𣾼	氵走戈乚
𥰊	竹亼口下
𣍂	八人口曲
𢹽	扌竹旡旡日
𢺳	扌言糸糸虫
𬝡	艹日月㇕丿
𡤠	女示曲一口䒑
𡮬	小門心
𦹹	艹氵厂土土
𩽸	魚食土土土兀
𦖡	耳白勹丶
𪣅	土廿乚
𠄜	一中彐亼木
𠰉	口召
𩳊	鬼夕口
𠾽	口門王
𪞽	亠乂凵曲辰
𬜞	𠂊巴非
𫲢	子勹口
𢀲	匚コ木口𠂊貝
𢀲	匚コ木口刀貝
淃	氵半卩
𣉏	日艹亼卩
𣉏	日艹亼龴
𪊅	卜圍乂木木示
𦨢	舟氏一
𦨢	舟氏丶
𫃖	米竹艮卩
攎	扌虎田皿
𦀅	糸𠂉㐄
盌	夕卩皿
𬲈	几二冂一口⺍廾
𦼇	艹亞心
㧡	扌亠凵人
𧋟	虫𠂉母
𥋷	目艹氵夂口
𫀟	示巳亼木
𠶖	口木王
𫽡	手八刀皿
𡊰	土田
𪴄	𠂉木耂阝
𦊛	四㇕一口
𤯨	生王廾
鈼	金𠂉匕
𩽤	魚酉鬼
𡓾	土示曲一口䒑
𬔑	穴虎爪丁
𥈯	目亻田土
𠌨	亻匚非
𣃱	方匚王
𦟖	䏑馬
𢺤	扌艹門木四
𢺤	扌艹門木日
𨃸	足立申
熶	火日耳又
熶	火冖二耳又
𫏦	足巛圍人儿キ
𤊒	火彑水
𦠰	户月卜日十
𩧍	馬石石石
𠸞	口火卜口
𢫞	扌又土
呭	口廿乚
𬛝	月厶口文厂彡
𪂳	鳥日匕匕
𧞣	衤厂日月犬
𨂘	足爪工一
𨂘	足爪丿士
𬈴	氵丰月中
𬓗	示彐水竹
𤞕	犭一冂土
䧹	广亻隹
𦞐	月虎匚一
𬚼	月王廾
𤢬	犭士口冖至
鐒	金火火冖力
𣯡	立申毛
𪧿	冂人小
𣃣	方皮
𫃤	糸氵女
𠾒	口牙隹
𤯺	生艹口丰力
𤯺	生廿口丰力
𤇳	火戊一
𩄒	雨立日
𡆑	口山口口厂丁耳攵
𡆑	口山口口厂㇕耳攵
䔅	艹丁口丁口
𤑬	火禾丿刀人水
𨯷	金艹癶一口䒑
𬰌	雨人户口刂
𬔌	穴牙千
𬩅	之氵耂
𫴵	彐寸手一丰
𢷅	扌足夂口
𩙋	風之亼月刂
𩙋	風之亼月巛
𦈽	午凵爪冖又
𣟃	木艹四冖一夕
𦇇	糸土土土兀土
𢸞	扌癶一口䒑阝
𥨧	穴婁攵
𤈪	火戈廾
𫑅	之木口亼卩
𫑅	之木口亼龴
𬒸	示乚艹廾
𨫄	金王刂王
𡄾	口言艹口丰
𡄾	口言廿口丰
𪟂	卜口刀
𫉳	艹厶口月巴
𩹯	魚十戈口
𦅴	尸毛糸氏一
𦅴	尸毛糸氏丶
𧵤	貝宀寸
捤	扌尸毛
橺	木門日
㤓	心木一
𡑒	土丁耳攵
𡑒	土㇕耳攵
𠖰	冫巳
𡏛	土爪幺大
𣾹	氵之召儿丶
菛	艹門
𬐐	白冖一兀彡
𬫂	金厂力
𬖩	米夕㐄竹
𠸩	口卜貝
𱔢	口犭耂
𨄠	足釆心
𠼹	口貝斤
𠹴	口尹口阝
鞵	革爪幺大
𫅁	四亻匕
𠲹	口巳心
𠦺	刂キ廾半
𩟢	食艹氵甫
𧛞	衤十口月
𪟡	田力丁口
𡎡	土甘木
𬚍	耂耂
𠯪	口一夕
𠟀	刀鳥
㳄	氵欠
𫠿	上癶一口䒑
𫑀	之刂キ廾キ
𬉵	大火
𤻐	疒立日欠
𧕚	虫齊示
𣴙	氵夕夕
䗅	虫長
𩈪	頁圍爿士
𫄐	糸八刀扌非
㺧	犭口口頁口口
𤌄	火耂
𪽕	勹巳田力
𦂽	糸穴犬
圚	圍中一貝
𠡚	二日力
襵	衤耳耳耳
𥆼	目田土
𤻑	疒广禾禾彐
𤀗	氵牛儿口口
𤀗	氵牛儿口丿口
𫡻	亡口月
𨁋	足一口䒑
𡲈	尸毛文
𫻠	心口月丶艮月
𪟤	王廾田力
𩍣	革艹廿乚木
𡉎	土工
𡓋	土隹尸毛
𠎊	亻木木木
𡄫	口言禾禾彐
𣼴	氵車欠
𤡛	犭宀一皿丁
𬕌	竹广木
𧉚	虫勿
𢄂	且力亠巾
𨆢	足雨田
𪜚	氵木攵乙
𢲣	扌立申
𦝇	月心日一
𠽌	口雨彐
𣈗	日一寸日
汵	氵亼㇕
𠾿	口工頁
𧻐	走文寸
𫳘	宀子宀丁
𪴉	木幺幺山八夂
𠽉	口氵冖儿木
𠽉	口氵冖八木
𩄱	雨立申
𫃘	米田艹廾半
𢭸	扌广予
𧋼	虫王廾
𬏒	田女丶艮
𣰏	毛山鬼
𠀲	丁夕夕
𫚶	爪丁鳥
𢹅	扌氵四勹虫
𠁀	廿乚亻弋
𩂁	雨兀
𤐝	火雨田
𪪅	干八大申
𬗓	糸䒑巾
𣈢	日鬼十
𱘔	土阝米夕㐄
𩠧	八頁尸㇕口
𬈤	氵尸匕生
𬑦	目白匕旡
𫽗	扌不皿
𫥴	巴刀
𨄶	足羊丶水
𣽆	氵竹工凡
𤷒	疒田牛
𨗮	之臼丨八廾
𣛨	木十日十月
𠮾	口兀
𪸊	氵爪尹土土土兀
𡀔	口足夂口
䏠	月立
𥯪	竹丰一大
𣊍	日广木木
𣊍	日广十儿十儿
𨤮	田土火火
𣖗	木之尸匕
𬆞	殳亡
𢁊	巴扌弋工
𪰹	日土田土
𪽁	生卜
𠅼	亡禾手丶
𦾥	艹日冖車
𠖨	冖一兀艹冖一豕
𣜲	木之𠂆十目
𢫈	扌十口
𪾮	目爪工一
𪾮	目爪丿士
𨮎	金艹氵夂口
𣹖	氵一夕且
瀐	氵十戈非一
𬢗	八人口𠂊用
𤳢	田力工貝
𠓻	人王亼冊
𫖀	頁圍一木
𣋂	日十日十月
𦄼	糸彡頁
𩠸	八頁竹馬
𢫟	扌亻士
𪠿	口竹
𢩜	户方𠂉矢
𢤟	心雨辰
𧲼	豸勹巳
𦢠	月齒
䴌	鳥艹冖一豕
𢫜	扌人上
𡏦	土羊工
𣘓	木四土厶
𪤸	夕卜竹
𠏭	亻耳又亻
𩝻	食十目廾
𩝻	食匕目廾
懙	心臼一乚丨廾
媠	女𠂇工月
𤠶	犭十目廾
𤠶	犭匕目廾
𡸏	山亻立
𬙼	羊大亠人人十
𡙴	立日儿大
𬰅	雨亼月刂
𬰅	雨亼月巛
𬨴	之艹厶口
𧍋	虫日一寸
𤓺	爪冫十
埬	土木日
𥆾	目刀丶心
𦢟	月扌业半大
𣈓	日扌皮
𪄥	鳥骨
𨔈	之牛巾刂
𤹕	疒圍大心
墛	土尸示寸
𠾹	丿大口亠人人十
𠄻	二乂木木
𠄻	工㇕木木
𤷳	疒山石
𪆼	雨田鳥
𤖡	爿宀一火日小
𫌵	又又言
𣜋	木口馬
𪱐	立日小丿目
𠐸	亼木土隹
𣖚	木艹力口
𠱈	口矢
𤠤	犭艹亡川
𥃑	舟皿乂凵八夂
𨬈	金广木木
𨬈	金广十儿十儿
𠣶	勹巳口力刂
𫒾	金糸冂人
𡒻	土斤斤貝
𥴛	竹木隹
𫏱	身亼四日
𣼷	氵革力
𣐝	木匚巾
𫖿	几二羊大
𣠩	木艹臣𠂉丶皿
𣠩	木艹臣𠂉一皿
𢟐	心王𠂉木
𠲏	口亻工一
𠲏	口亻丿士
䘃	虫四土火土
䘃	虫田土火土
𩺥	魚勹屮勹屮
㖽	口頁
𢷀	扌亼月刂心
𢷀	扌亼月巛心
𠚯	兀刂
𢭺	扌豸
𬈫	氵行日一寸
𤒢	火广亠圍口禾
𩽥	魚門木四
𩽥	魚門木日
𠶏	口禾彐
𧜘	衤口貝
𣊿	日十日十月
𬃱	木十口日一
𤄋	氵糸囟夂心
𤄋	氵糸囟丿乂心
𣻄	氵行亼木
𫷤	幺力之丿㠯
𩼸	业羊寸魚
櫈	木癶一口䒑几
𪥻	女干丿之
𨙛	之木口丿皿亻
𢺹	八刀十又
𱠳	扌田土八土
溳	氵口貝
𬯰	隹又示乚
𢷆	手亠圍口日一
𠃷	禾子乙
𦢷	月口口馬
𢯑	扌心又土
𡓈	土禾尤匕日
𧕀	虫尸口辛土
𠶇	口巾丶水
㗈	口龴用力
𣼲	氵口隹
𱍧	彐工口寸下
𤊫	火土皮
𠼸	口亻匚日女
䈜	竹亻彐冖又
𬑩	目千艹二午
𫫤	口户口攵
𤉓	厂火由
𬠫	虫艹日月
𠎫	亻十日十月
𥊀	目厶厶厶人彡
𫴱	彐寸𠂉母
𠯻	口幺㇕
𣹙	氵𠂇月阝
𫑇	之斤甘廾
𣍗	人亠乂凵冂厶曲
𦬂	艹兀
𫻎	立日欠心
𪚚	龍中
𫡐	㇕丿竹
𫺶	心阝車
𠻄	口艹亡川
𬠱	𠂉母大八虫
𬚲	䏑心
崊	山木木
𪘵	齒土儿夂
𪘵	齒土八夂
焝	火氏日
𫣿	四貝人心
佊	亻皮
𨒒	之一力十
𦞒	月行土寸
𱔫	口穴牛口
𪯗	廿月攵八刀
𠴓	口亻氏一
𠴓	口亻氏丶
𣠒	宀釆田𠂉木
𦇒	糸石石石
𠓔	臼儿艹四冖夕
𤾔	白艹冖木
𦢩	月艹尹爿一爿
𲇣	金艹勹米
𫧦	亠幺⺍十竹
𭉩	口亻立口
𫊴	虫扌丿七
𠁔	立立由丂
𢨃	艹日大戈
𤞘	犭亻工一
𤞘	犭亻丿士
𩿘	鳥毛
㽿	疒瓜
𢥢	心言艹口丰
𢥢	心言廿口丰
𣔲	木之冂口
㘉	口竹艮卩
𢿼	彐工口寸攵
𤷯	疒尸巾刂
𢫠	扌弓厶
𡌽	土广卜口
𪤲	士尸竹
𡃕	口穴身弓
𢲵	扌一曲日
𨃴	足骨
𧅕	艹月巛圍乂巛
鐰	金口口口木
𪮳	扌大八虫
𪄧	鳥之䒑屮
𠲕	口广土
𠹽	口艹亠凵人
𫽌	扌殳勿
𣹘	氵行土寸
㭼	木水日
𧊌	虫工丂
𥸆	竹月巛圍乂巛
𦀼	糸山冂人
𢄹	巾丿大口冂口
𪩤	匚コ一夕刂
𢴑	扌釆心
𬢱	言羊又
𧧀	言瓦
𩅺	雨彡頁
𪩧	亠口冖丁匚コ
㴜	氵户冊
𫖾	亼月刂几二
𫖾	亼月巛几二
𣑵	木彐キ
𱜘	亼冊匚コ
𠬃	土厶甫
𢤣	心竹䒑月刂
帀	一巾
𣳡	氵戊
𧸺	貝穴身弓
𣂃	耂冫十
𣨭	一夕宀㠯
𩊽	革乂𠂇巾
𣛦	木氵方𠂉子
𫯖	夕夕之䒑大
鵶	亞鳥
𡳩	尸毛彐キ日
𨓢	之斤兀
𪰨	日心户
𡗎	夕夕車斤日
𦀫	糸广犬
𠑕	亻匕卩言二乂口
𠑕	亻匕卩言工㇕口
𢩊	户小兀
𣊾	日非心
𠶯	口扌屮凵
𪵯	氵爪
𫐾	之豕不
𦲹	艹亠亻夂丶
𡓥	土口口甲一戈
𢲝	糸丿屮手
𢲝	糸一屮手
啱	口山石
𬗰	糸一夕𠂉木
𡢐	婁𠂆一口
𤳆	田力木人人
𡍣	土大八又
𧙀	衤立
𥝽	禾下乚
𫿴	冫十爪子
𠶗	口十目
𤔽	爪艹冖一豕
𩲡	示鬼
㫼	日牛巾刂
𠇽	亻匚巾
𡄯	口月立日心
𧋸	虫口王
𧋸	虫口亻土
𬬌	金戈戈木一
𥣐	禾日冖車
𪀆	亻士鳥
𨨦	金木攵
𨯃	金婁攵
𣔓	木行皮
𫨫	厶卜貝
㗅	口十口月
𨨧	金立女
𪆤	四土火鳥
𪆤	田土火鳥
𪇴	艹四戈人鳥
𡮫	䏑犬火小
𫆍	耳丶艮月
𪧚	宀子宀寸
𫆘	月一卜
𠺳	口尤匕日
𥶲	竹石石石
𦧽	舌彑水虫虫
𡳽	竹馬尸至
𪽄	生小冂口
𥖓	石皮口口
𥖓	石皮口丿口
𤴏	田艹廾四糸隹
𣜿	木艹廿乚木
𬟼	虫一木
𢴔	扌貝厂又
𢴔	扌貝𠂆又
𥘷	示乚小丿
𨄷	足大乂乂乂乂
𫇳	艹人上
𬄃	木矢匚コ
𣷷	氵大八又
𬷤	爪丁口鳥
𬀰	日一夕刂
𧛌	衣十丿犬丿
𧛌	衣十丿犬㇕
𬄮	木十口心日一
𢯓	扌艹巴
𠚐	屮凵木
𤯆	甘言
𠾻	口氵甘匚儿
𠾻	口氵甘匚八
𤷴	疒亻衣
𦾣	艹扌冖隹
𫪥	口亻夕夕
筙	竹耒
扖	扌人
𨮹	金之亠八冂十口
㾞	疒酉
𣭒	毛目
𩇅	雨言艹日大
呞	口㇕一口
𥊴	目日耳又
𥊴	目冖二耳又
梖	木貝
𤇲	亻工一火
𤇲	亻丿士火
𢝸	心咼
恗	心大一丂
恗	心大丂一
𬏯	疒豸
𡅧	口廿口夫隹
𡅧	口艹口夫隹
𬇸	氵一丂木一
𬇸	氵丂一木一
𧄳	艹日十丿大口冂口
𫶷	口口巴
𫶷	口丿口巴
哠	口牛口
萶	艹丰日
𪰬	日一禾刂
𥙧	示乚𠂉小
𥙧	示乚𠂊小
𥙧	示乚竹八
𤍎	火丶艮阝
𣔥	木行一止
㗚	口西木
𪳘	木冖一豕
𪲝	木广木
